----------------------------------------------------------------------------------------------------------------------------------------------------------------------------------------------------------------
----------------------------------------------------------------------------------------------------------------------------------------------------------------------------------------------------------------
----------------------------------------------------------------------------------------------------------------------------------------------------------------------------------------------------------------
----------------------------------------------------------------------------------------------------------------------------------------------------------------------------------------------------------------
----------------------------------------------------------------------------------------------------------------------------------------------------------------------------------------------------------------
----------------------------------------------------------------------------------------------------------------------------------------------------------------------------------------------------------------
-----------------------------------------------------------------------------------------XX---------XX--------XXX---------------------------XX---------XX-------X-----------------------------------------------
--------------------------------------------------XX-------------------------------------XX--------XXX--------XXX--------------------------XXX--------XXX------EX-----------------------------------------------
-------------------------------------------------XXX-----------------------------------XXXX-------XXXX--------XXX-------------------------XXXX-------XXXX------XX-----------------------------------------------
------------------------X------------------------XXX-----------------------------------XXXX------XXXXX--------XXX------------------------XXXXX------XXXXX------XX-----------------------------------------------
-----------------------XX----------------------X-XXX----------------XX----------------XXXXX-----XXXXXX--------XXX-----------------------XXXXXX------XXXXX------XX-----------------------------------------------
----------------------XXX---------------------XX-XXX----------------XX---------------XXXXXX-----XXXXXX--------XXX----------------------XXXXXXX------XXXXX------XX----------------------------XX-----------------
---------------------XXXX--------------------XXX-XXX----------------XX--------------XXXXXXX-----XXXXXX--------XXX---------------------XXXXXXXX------XXXXX------XX---------------------------XXX-----------------
--------------------XXXXX-------------------XXXX-XXX----------------XXX------------XXXXXXXX-----XXXXXX--------XXX--------------------XXXXXXXXX------XXXXX------XX--------------------------XXXX-----------------
XXXXX--------------XXXXXX----------XXXXXX--XXXXX-XXXXXXXXXXXXXX-----XXXXXXXXXXXXXXXXXXXXXXXXXXX-XXXXXXXXX-----XXX---------------X-X-XXXXXXXXXXXXX---XXXXX------XXXXXXXXXXXXXXXXXXXXXXXXXXXXXXXX-----------------
XXXXX--------------XXXXXX----------XXXXXXXXXXXXX-XXXXXXXXXXXXXX-----XXXXXXXXXXXXXXXXXXXXXXXXXXXXXXXXXXXXX-----XXX------------XX-XXXXXXXXXXXXXXXXX---XXXXX------XXXXXXXXXXXXXXXXXXXXXXXXXXXXXXXX-----------------
