----------------------------------------------------------------------------------------------------------------------------------------------------------------------------------------------------------------
----------------------------------------------------------------------------------------------------------------------------------------------------------------------------------------------------------------
----------------------------------------------------------------------------------------------------------------------------------------------------------------------------------------------------------------
----------------------------------------------------------------------------------------------------------------------------------------------------------------------------------------------------------------
----------------------------------------------------------------------------------------------------------------------------------------------------------------------------------------------------------------
-------------------------------------------------------------------------------------------------------------------------------------------------------------------------E--------------------------------------
XX----------XX------------------XXX-----------X-------------------------------------------------------------------------XX----------------------XX------------------SSSS----------------------------------------
XX----------XX------------------XXX----------------------------------------------------------------X-----X--------------XX----------------------XX--------------------------------------------------------------
XX--------X-XX------------------XXX-------------------------------------------------E-------------XXXXX---------------XXXX--------------------XXXX-------------------------------------------------------------X
XX--------X-XX------------------XXX--------------------------------------------------XXX---------XXX------------------XXXX--------------------XXXX------------------------------------------------------------XX
XX--------X-XX------------------XXX-------------------------------------------------------------XXXX----------------XXXXXX--------------------XXXX-------------------S--------------------------------------XXXX
XX--------X-XX------------------XXX------------------------------------------------------------XXXXX---------------XXXXXXX--------------------XXXX----------------------------------------------------------XXXX
XX--------X-XX------------------XXX-----------------------------------------------------------XXXXXX--E-----------XXXXXXXX-----------------X--XXXX----------------------------------------------------------XXXX
XX--------X-XX------------------XXX------------------------------------------------X---------XXXXXXX-<>----------XXXXXXXXX-----------------X--XXXX-----------------------------X---------------------------XXXXX
XX--------X-XX------------------XXX-----------XXXXXXXXXXXXXXXXXXXXXXXXXXXXXXXXXXXXXX---------XXXXXXX-[]----------XXXXXXXXXXXXXXXXXXXXXXXX--X--XXXX-XXXXXXX-------XXXXXXXXXXXXXXX-------------XXXXXXXXXXXXXXXXXXX
XX--------X-XX------------------XXX-----------XXXXXXXXXXXXXXXXXXXXXXXXXXXXXXXXXXXXXX---------XXXXXXX-[]----------XXXXXXXXXXXXXXXXXXXXXXXX--X--XXXX-XXXXXXX-------XXXXXXXXXXXXXXX-------------XXXXXXXXXXXXXXXXXXX
