----------------------------------------------------------------------------------------------------------------------------------------------------------------------------------------------------------------
----------------------------------------------------------------------------------------------------------------------------------------------------------------------------------------------------------------
----------------------------------------------------------------------------------------------------------------------------------------------------------------------------------------------------------------
----------------------------------------------------------------------------------------------------------------------------------------------------------------------------------------------------------------
----------------------------------------------------------------------------------------------------------------------------------------------------------------------------------------------------------------
----------------------------------------------------------------------------------------------------------------------------------------------------------------------------------------------------------------
-------------------------------------------------------------------------------------------------------------------------------------XX--------XX----------------------------X----------------------------------
---------------------------------XX------------------XX-------XX--------XX---------------------------------------------XX-----------XXX--------XX------------XX-------------XXX---------------------------------
--------------------------------XXX-----------------XXX------XXX-------XXX--------------------------------------------XXX----------XXXX--------XX----------XXXX------------XXXX---------------------------------
-------------------------------XXXX-----------------XXX-----XXXX------XXXX-------------------------------------------XXXX----------XXXX--------XX----------XXXX-----------XXXXX---------------------------------
------------------------------XXXXX---------------X-XXX-----XXXX-----XXXXX------------------------------------------XXXXX--------X-XXXX--------XX----------XXXX----------XXXXXX---------------------------------
-----------------------------XXXXXX--------------XX-XXX---XXXXXX----XXXXXX---------XX------------------------------XXXXXX----------XXXX--------XX-------X--XXXX---------XXXXXXX---------------------------------
------------------------E---XXXXXXX-------------XXX-XXX---XXXXXX---XXXXXXX---------XX-----------------------------XXXXXXX----------XXXX--------XX------XX--XXXX---------XXXXXXX---------------------------------
---------------------------XXXXXXXX------------X-XX-XXX---XXXXXX---XXXXXXX---------XX----------------------------XXXXXXXX----------XXXX--------XX-----XXX--XXXX---------XXXXXXX---------------------------------
--------------------------XXXXXXXXX-----------XX-XX-XXX---XXXXXX---XXXXXXX---------XX---------------------------XXXXXXXXX----------XXXX--------XX----XXXX--XXXX---------XXXXXXX--------X------------------------
XXXXXXXXXXXXXXXXXXXXXXXXXXXXXXXXXXXXXXXXXXXXXXXXXXX-XXXXXXXXXXXXXXXXXXXXXXXXXXXXXXXXXXXXXXXXXXXXXX-XXXXXXXX--XXXXXXXXXXXXXXX-X-----XXXXX-------XXXXXXXXXX--XXXXXXXXXXXXXXXXXXXXXXXXXXXXXXXXXXXXXXXXXXXXXXXXXXXXX
