----------------------------------------------------------------------------------------------------------------------------------------------------------------------------------------------------------------
----------------------------------------------------------------------------------------------------------------------------------------------------------------------------------------------------------------
----------------------------------------------------------------------------------------------------------------------------------------------------------------------------------------------------------------
--------------------SSSSSSSSSSSSSSSSS------------------------------------------------------------------SSSSSSSSSSSSSSSSSSSSSSSSSSSS----------------------------------------------------SSSSSSSSSSSSSSSSSSSSSSSSS
-----------------SS---------------------------------------------------------------------------------------------------------------------------------------------------------------------------------------------
----------------------------------------------------------------------------------------------------------------------------------------------------------------------------------------------------------------
---------------------------------------------------------------------------------------------SSSSSSSS-----------------------------------------S--SSSSSSSSSSSSS--------------------------------------------------
----------------------------------------------------------------------------------------------------------------------------------------------------------------E-----------------------------------------------
----------------------------------------------------------------------------------------------------------------------------------------------------------------------------------------------------------------
-------------------XXXXX-------------------------------------------------------------------------------------------------------------------------------E--------------------------------XXXX--------------------
------------------XXXXXX------------------------XXX----------------------XXX---------XXXXX----SSSSSSS-----------------------------------XXXXX-----SSSSSSSSSSSS-------------------------XXXXX--------------------
-----------------XXXXXXX------------------------------------------------XXXX--------XXXXXX---------------------------------------------XXXXXX-------------------XX--------------------XXXXXX------------X-------
----------------XXXXXXXX---XX------------------------------------------XXXXX-------XXXXXXX--------------------------------------------XXXXXXX------------------XXX-------------------XXXXXXX---XXX--------------
---------------XXXXXXXXX----------------------------------------------XXXXXX------XXXXXXXX---------E-E------------------------------XXXXXXXXX-----------EE----XXXX------------------XXXXXXXX--------------------
-------XXXXXXXXXXXXXXXXXX------------XXXXXXXXX--------------XXXX-----XXXXXXX-XXXXXXXXXXXXXXXXXXXXXXXXXXXXXX-------------------------XXXXXXXXXXXXXXXXXXXXXXXXXXXXXX-----------------XXXXXXXXXX-------------------
-------XXXXXXXXXXXXXXXXXX------------XXXXXXXXX--------------XXXX-----XXXXXXX-XXXXXXXXXXXXXXXXXXXXXXXXXXXXXX-------------------------XXXXXXXXXXXXXXXXXXXXXXXXXXXXXX-----------------XXXXXXXXXX-------------------
