----------------------------------------------------------------------------------------------------------------------------------------------------------------------------------------------------------------
----------------------------------------------------------------------------------------------------------------------------------------------------------------------------------------------------------------
----------------------------------------------------------------------------------------------------------------------------------------------------------------------------------------------------------------
----------------------------------------------------------------------------------------------------------------------------------------------------------------------------------------------------------------
----------------------------------------------------------------------------------------------------------------------------------------------------------------------------------------------------------------
----------------------------------------------------------------------------------------------ooooooo---E-------------------------------------------------------------------------------------------------------
SSSSSSSSS---------------XX----------XX---------XX--------------------------------------------SSSSSSSSSSSSSS----------------------------------------------------------------------------------SSSSSSSSSSS--------
-----------------------XXX---------XXX---------XX---------------------------------------------------------E---------------------------------------XX------------------------------------------------------------
----------------------XXXX--------XXXX---------XX----------------------------------------------------------------------------------------------E----------------------------------------------------------------
---------------------XXXXX-------XXXXX---------XX-------------------------------------------------------------------------------------------------------------------------------------------------E-------------
--SSSSSSS-----------XXXXXX------XXXXXX---------XX-----------------------------X---------------SSSSSSSSSSS--X--------------------XXX--------------------------XX--------------------------------SSSSSSSSS--X-----
-------------------XXXXXXX-----XXXXXXX---------XX----------------------------XX----------------------------X--------------------XXX-------------------------XXX-------------------------------------------XX----
------------------XXXXXXXX----XXXXXXXX---------XX---------------------------XXX--------------------------XXX--------------------XXXX-----------------------XXXX-------------------------------------------XX----
-------E---------XXXXXXXXX---XXXXXXXXX---------XX--------------------------XXXX---------------------E---XXXXX-------------------XXXXX---------------------XXXXX-------------------------------------E-E----X----
XXXXXXXXXXXXXXXXXXXXXXXXXXXXXXXXXXXXXXXX-------XXXXXXXXXXXXXXXXXXXXXXXXXXXXXXXX-------------XXXXXXXXXXXXXXXXXXXXXXXXXX--XXXX----XXXXXX--------------------XXXXXXXXXXXXXXXXXXXXXXXXXX---XXXXXXXXXXXXXXXXXXXXXXXX-
XXXXXXXXXXXXXXXXXXXXXXXXXXXXXXXXXXXXXXXX-------XXXXXXXXXXXXXXXXXXXXXXXXXXXXXXXX-------------XXXXXXXXXXXXXXXXXXXXXXXXXX--XXXX----XXXXXX--------------------XXXXXXXXXXXXXXXXXXXXXXXXXX---XXXXXXXXXXXXXXXXXXXXXXXX-
