----------------------------------------------------------------------------------------------------------------------------------------------------------------------------------------------------------------
----------------------------------------------------------------------------------------------------------------------------------------------------------------------------------------------------------------
----------------------------------------------------------------------------------------------------------------------------------------------------------------------------------------------------------------
----------------------------------------------------------------------------------------------------------------------------------------------------------------------------------------------------------------
----------------------------------------------------------------------------------------------------------------------------------------------------------------------------------------------------------------
----------------------------------------------------------------------------------------------------------------------------------------------------------------------------------------------------------------
----------------------------------------------------------------------------------------------------------------------------------------------------------------------------------------------------------------
--------------------------------------------------------------------------------------------------------------------------------------------------XX------------------------------------------------------------
--------------------------------------------------------------------------------------------------------------------------------------------------XX------------------------------------------------------------
-------------------------------------------------------------------o-----------------------oo----------------------------------------------------XXX------------------------------------------------------------
---------------------------X-----------------------------------X-------------------------------------------------------------------------------X-XXX--------------------------------------SSSSSSSSS-------------
--------------------------XX----------------------------------XXX-----------XX--X-------------------------------------------------------------XX-XXX------------------------------------------------------------
----------X--------------XXX----------X----------------------XXXX----------XXX--XX------X----------------------------------------------------XXX-XXX------------------------------------------------------------
----------X-------------XXXX---------XX---------------------XXXXX---------XXXX--XX-----XX---------------------------------------------------XXXX-XXX--------X-----------------E---------------------------------
----------X------------XXXXX-------------------------------XXXXXX--------XXXXX--XXX---XXX----------------------------------------E----E----XXXXX-XXX--------X----E----------------------------------------------
XXXXXXXXXXXXXXX-X-XXXXXXXXXXXXXXXXXXXXXXXX-X--X---XXX--XXXXXXXXXX---XXXXXXXXXX--XXXXXXXXXXXXXXXXXXXXXXXXXXXXXXXXXXXXX-X---XXXXXXXXXXXXXXXXXXXXXX-XXXXXXXXXXXX-XXXXXXXXXXXXXXXXXXX-XXXXXXXXXXXXXXXXXXXX-XXXXX--XX
