----------------------------------------------------------------------------------------------------------------------------------------------------------------------------------------------------------------
----------------------------------------------------------------------------------------------------------------------------------------------------------------------------------------------------------------
----------------------------------------------------------------------------------------------------------------------------------------------------------------------------------------------------------------
----------------------------------------------------------------------------------------------------------------------------------------------------------------------------------------------------------------
-----------------------------------------------------------------------------------------------E----------------------------------------------------------------------------------------------------------------
----------------------------------------------------------------------------------------------------------------------------------------------------------------------------------------------------------------
----------------------------------------------------------------------------------------------------------------------------------------------------------------------------------------------------------------
------------------------------------------------------------XX--------------XX------------------XX---------------------------------------------------------------------------------------------------XX---------
-------------------------------------SSS-------------------XXX--------------XX-----------------XXX--------------------------------------------------------------------------------------------------XXX---------
------------------------------------X---------------------XXXX--------------XXX---------------XXXX-------------------------------------------------------------------------------------------------XXXX---------
-----------------------------------XX--------------------XXXXX-----------X--XXX--------------XXXXX----------------------------------------------------X-------------------------------------------XXXXX---------
----------XXXX--------------------XXX----------X--------XXXXXX----------XX--XXX-------------XXXXXX---------------------------------------------------XX------------------------------------------XXXXXX---------
---------XX----------------------XXXX---SS-----XX-------XXXXXX---------XXX--XXX--------E---XXXXXXX-------------------------------------------------EXXX-----------------------------------------XXXXXXX---------
--------XXX---------------------XXXXX----------XX-----X-XXXXXX--------X-XX--XXX-----------XXXXXXXX-------------------------------------------------XXXXX---------------------------------------XXXXXXXX---------
------XXXXX--------------E-----XXXXXX----------XX-----X-XXXXXX-------XX-XX--XXX----------XXXXXXXXX------------------------------------------------XXXXXX--------------------------------------XXXXXXXXX---------
XXXXXXXXXXX------X-XXXXXXXXXXXXXXXXXXXXXX--XXXXXXXXXXXXXXXXXXXXXXXXXXXX-XX--XXXXXXXXXXXXXXXXXXXXXXXXXXXXXXXXXXXXXXXXXX-XX-XXXXXXXXXXX-XXXXXXXXXXXXXXXXXXXXXXXXXXXXXXXXXXX-XXXXXXXXXXXXXXXXXXXXXXXXXXXXXXXXXXXXXX
