----------------------------------------------------------------------------------------------------------------------------------------------------------------------------------------------------------------
----------------------------------------------------------------------------------------------------------------------------------------------------------------------------------------------------------------
----------------------------------------------------------------------------------------------------------------------------------------------------------------------------------------------------------------
----------------------------------------------------------------------------------------------------------------------------------------------------------------------------------------------------------------
----------------------------------------------------------------------------------------------------------------------------------------------------------------------------------------------------------------
----------------------------------------------------------------------------------------------------------------------------------------------------------------------------------------------------------------
----------------------------------------------------------------------------------------------------------------------------------------------------------------------------------------------------------------
--------------------------------------------------------XX-----------------------XXX---------------------------------------------XX-----------------------XX----------------------------------------------------
-------------------------------------------------------XXX----------------------XXXX-------------------------------------------XXXX----------------------XXX----------------------------------------------------
-----------------------------------------------------EXXXX---------------------XXXXX----------------------------------X--------XXXX---------------------XXXX---------------------------------X------------------
-----------Q-----------------------------------------XXXXX--------------------XXXXXX---------------------------------XX------X-XXXX---------------------XXXX--------------------------------XX------------------
------XX--------------------------------------------XXXXXX-------------------XXXXXXX----------------XX--------------XXX------X-XXXX---SQQ-------------X-XXXX-------------------------------XXX------------------
-----XX--------------------------------------------XXXXXXX------------------XXXXXXXX--------------XXX--------------XXXX-----XX-XXXX-------------------X-XXXX-------------------------------XXX------------------
----XXX-------------------------------------------XXXXXXXX-----------------XXXXXXXXX--------------XXXX------------XXXXX---XXXX-XXXX----------------XX-X-XXXX-----------------------------X-XXX------------------
---XXXX----SSSS----------------------------------XXXXXXXXX----------------XXXXXXXXXX------------XXXXXX-----------XXXXXX--XXXXX-XXXX----------------XX-X-XXXX-------------------------------XXX------------------
XXXXXXX--------XX-XXXXXXXXXXXXXXXXXXXX-XXX-XXXXXXXXXXXXXXXXXXXXXXXXXXXXXXXXXXXXXXXXXXXXXXXXXXXXXXXXXXX------XXXXXXXXXXXXXXXXXX-XXXXXXXXXXXXXXXXXXXXXX-X-XXXXXXXXXXXXXXXXXXXXXXXXX-XXXXXXXXXXXXXXXXXXXXXX--------
