----------------------------------------------------------------------------------------------------------------------------------------------------------------------------------------------------------------
----------------------------------------------------------------------------------------------------------------------------------------------------------------------------------------------------------------
----------------------------------------------------------------------------------------------------------------------------------------------------------------------------------------------------------------
----------------------------------------------------------------------------------------------------------------------------------------------------------------------------------------------------------------
----------------------------------------------------------------------------------------------------------------------------------------------------------------------------------------------------------------
----------------------------------------------------------------------------------------------------------------------------------------------------------------------------------------------------------------
----------------------------------------------------------------------------------------------------------------------------------------------------------------------------------------------------------------
-------XXX------------------------------------------------------------------------------------------------XX-------------------------------------------------------------XXX--------------------------XXX-------
------XXXX-----------------------------------------------------------------------------------------------XXX-------------------------------------------------------------XXX--------------------------XXX-------
-----XXXXX---------------------X-------------------------------------------------------------------------XXX-------------------------------------------------------------XXX---------------X----------XXX-------
----XXXXXX--------------------XX-----------------------------------------------------------------------X-XXX-------------------------------------------------------------XXX--------------XX-------X--XXX-------
---XXXXXXX-------------------XXX-----------------------------------------------------------------------X-XXX----------------------------------------------------------X--XXX-------------XXX------XX--XXX-------
--XXXXXXXX------------------XXXXX-----------E----------------------------------------------------------X-XXX------------XXX--------------------------------------E---XX--XXX------------XXXX-----XXX--XXX-------
-XXXXXXXXX-----------------XXXXXX--------------------------------------------------------------------X-X-XXX------------XXX-----------------------------------------XXX--XXX-----------XXXXX----XXXX--XXX-------
XXXXXXXXXX------------------XXXXX--------------------------------------------------------------------X-X-XXX-----------XXXX----------------------------------------XXXX--XXX----------XXXXXX---XXXXX--XXX-------
XXXXXXXXXXXXXXXXXX------XXXXXXXXXXXXXXXXXXXXXXXXXXXXXXXXXXXXXXXXXXXXXXXXXXXXXXXXX---XXXX-------------X-X-XXX------XX-XXXXXXXXXXXXXXXXXXXXXXXXXXXXXXXXXXXXXXXXXXXXXXXXXX--XXXXXXXXXXXXXXXXXXXXXXXXXXX--XXXXXXXXXX
