----------------------------------------------------------------------------------------------------------------------------------------------------------------------------------------------------------------
----------------------------------------------------------------------------------------------------------------------------------------------------------------------------------------------------------------
----------------------------------------------------------------------------------------------------------------------------------------------------------------------------------------------------------------
----------------------------------------------------------------------------------------------------------------------------------------------------------------------------------------------------------------
----------------------------------------------------------------------------------------------------------------------------------------------------------------------------------------------------------------
-----------------------------------------------------------------------------------------------------------------E----------------------------------------------------------------------------------------------
---SSSSSSSSSSSS--X-------------------------------------------------------------------------------------------SSSSSSSSSS--------------------------------------------E--SSSSSSSSSSSSS-----------------------------
-----------------X----------------------------------------------------------------------------------------------------------------------------------------------------------------------------------------------
-----------------X----------------------------------------------------------------------------------------------------------------------------------------------------------------------------------------------
--------------X-XX-----------------------------------------------------------------------------------------------EE-------------------------------------------------------------------------X-------------------
--------------X-XX------------------------XX----------------------XX----------------XX-----------------------SSSSSSSSSS------------XX-----------------------------------SS----SSSSSSSSSSSSSSX-------------------
--------------X-XX------------E-----------XXX---------------------XX----------------XXX----XXX-----XX-----------------------------------------------------------------------X-----------------------------------
-----------X--X-XX------------------------XXXX--------------------XX----------------XXXX------------------------------------------------------------------------------------X-----------------------------------
----------------XX-------------------X----XXXXX-------------------XX----------------XXXXX----------------------------E------------------------------------------------------X--------------------------------E--
---------XXXXXXXXXXXXXXXXXXXXXXXXXXXXX----XXXXXXXXXXXXXXXXXXXXXXXXXXXXXXXXXXXXXXXXXXXXXXX------------------XXXXXXXXXXXXX---XXXXXX------------------------------------XXXXXXXXXXXXXXXXXXXXXXXXXXXXXXXXXXXXXXXXXXX
---------XXXXXXXXXXXXXXXXXXXXXXXXXXXXX----XXXXXXXXXXXXXXXXXXXXXXXXXXXXXXXXXXXXXXXXXXXXXXX------------------XXXXXXXXXXXXX---XXXXXX------------------------------------XXXXXXXXXXXXXXXXXXXXXXXXXXXXXXXXXXXXXXXXXXX
