----------------------------------------------------------------------------------------------------------------------------------------------------------------------------------------------------------------
----------------------------------------------------------------------------------------------------------------------------------------------------------------------------------------------------------------
----------------------------------------------------------------------------------------------------------------------------------------------------------------------------------------------------------------
----------------------------------------------------------------------------------------------------------------------------------------------------------------------------------------------------------------
---------------------------------------------------------------------------------------------------------------------------------------------------------------------------------------------E------------------
----------------------------------------------------------------------E-----------------------------------------------------------------------------------------------------------------------------------------
------------------------------------------------------------SSSSSSSSSSSSSSSS------------------------------------------------------------------------------------------------------------------------------------
--------------XX----------------XX---------------------------------------E--------------------------------------------X------------------------------------------------------XX---------------XX----------------
---------E---XXX---------------XXX------------------------------------------------------------------------------------X------------------------------------------------------XX--------------XXX----------------
-------------XXXX-------------XXXX---------------------------------------------------------------------------------E--X-------------------------------------------X---------XXX-------------XXXX----------------
-----------X-XXXX------------XXXXX-------------------------X---SSSSSS-----<>---------------------X-----------------X--X-------------------------------------------X---------XXX-------------XXXX----------------
----------XX-XXXX-----------XXXXXX---QQQQ-----------------XX--------------[]-------------------XXX-----------------X--X--------Q---------------------------------XX-------X-XXX-----------X-XXXX---Q------------
---------XXX-XXXX----------XXXXXXX-----------------------XXX--------------[]-----------------EXXXX--------------X--X--X-----------------------------------------XXX------XX-XXX----------XX-XXXX----------------
--------XXXX-XXXX---------XXXXXXXX-----------------------XXX--------------[]-----------------XXXXX------------X-X--X--X-----------------------------------------XXX-----XXX-XXX---------XXX-XXXX----------------
-------XXXXX-XXXX--------XXXXXXXXX---------------------XXXXXXXXXXXXXXXXXXXXXXXX-X----X------XXXXXX------------X-X--X--X---------------------------------------X-XXX----XXXX-XXX--------XXXX-XXXX--------X------X
-----X-XXXXX-XXXXXXXXXXXXXXXXXXXXXXXXXXXXXXXXXXXXXXXXXXXXXXXXXXXXXXXXXXXXXXXXXXXXXXXXXXXXXXXXXXXXXXXXXXXXXXXX-X-X--X--XXXXXXXXXXXXXXXXXXXXXXXXXX-XXX-X-XXXXXXXXXXXXXXXXXXXX-XXXXXXXXXXXXXXX-XXXXXXXXXXXXXXXXXXXX
