----------------------------------------------------------------------------------------------------------------------------------------------------------------------------------------------------------------
----------------------------------------------------------------------------------------------------------------------------------------------------------------------------------------------------------------
----------------------------------------------------------------------------------------------------------------------------------------------------------------------------------------------------------------
----------------------------------------------------------------------------------------------------------------------------------------------------------------------------------------------------------------
----------------------------------------------------------------------------------------------------------------------------------------------------------------------------------------------------------------
----------------------------------------------------------------------------------------------------------------------------------------------------------------------------------------------------------------
----------------------------------------------------------------------------------------------------------------------------------------------------X-----------------------------------------------------------
---------------------------------------------------------------------XX----------------------S----------------X------------------------------------XXX----------------------------------------------------------
----------------------------------------------------------------E---XXX--------------------------------------XX-----------------------------------XXXX----------------------------------------------------------
-------------------------XX-----------------------------------------XXX-------------------------------------XXX---------------------oo-----------XXXXX----------------------------------------------------------
------------------------XXX---------------------------------------X-XXX---------------------E-E------------XXXX---------SSS---------------------XXXXXX----------------------------------------------------------
---------------------X--XXX---------------X----------------------XX-XXX-------XXXXXXXXXXXXXXXXXXX---------XXXXX-----------------XX-------------XXXXXXX------Q----------------XXX--XXX---------------------------
----------------E----X--XXX---------------XX---------------------XX-XXX-------------------------X--------XXXXXX----------------XXX------------XXXXXXXX--------------E------EXXXX--------------------------------
-------------------X-X--XXX---------------XXX------------------X-XX-XXX-------------------------XX------XXXXXXX---------------XXXX-----------XXXXXXXXX---------------------XXXXX--------------------------------
------------------XX-X--XXX---------------XXXX----------------XX-XX-XXX-------------------------XX-----XXXXXXXX--------------XXXXX----------XXXXXXXXXX--------------------XXXXXX--------------------------------
---XXXXXXXXXXXXXXXXX-X--XXXXXX--XXXXXXXXXXXXXXXXXXXXXXXXXXXX-XXX-XX-XXXXXXXXXX------------------XXXXXXXXXXXXXXXXXXXXXXXXXXXXXXXXXXXXXXXXXXXXXXXXXXXXXXXXXXXXXXXXXXXXXXXXXXXXXXXX--------------------------------
