----------------------------------------------------------------------------------------------------------------------------------------------------------------------------------------------------------------
----------------------------------------------------------------------------------------------------------------------------------------------------------------------------------------------------------------
----------------------------------------------------------------------------------------------------------------------------------------------------------------------------------------------------------------
----------------------------------------------------------------------------------------------------------------------------------------------------------------------------------------------------------------
-----------------------------------------------------------------------------------------------------------------------------------------------------------------------------------------------------------E----
----------------------------------------------------------------------------------------------------------------------------------------------------------------------------------------------------------------
---------------XX-----------------------------------------------------------------------------------------------------------------------------------------------------------------------------------------------
--------------XXX-------------------------------------------------------------------------------------------------SSS------------XX-X-----------------------------------------------------------------------XX--
--------------XXX----------------------------------------------------------------------------------------------------------------XX-X------------------------------------------------------------------E---XXX--
------------X-XXX---------------------------------------------------------------------------------------------------------------XXX-X------------------------------X---------------------------------------XXX--
-----------XX-XXX---------------------------------------------------------------------------------------------X---------------X-XXX-X-----------------------------XX-------------------------------------X-XXX--
-----------XX-XXX---SQ----E----------------------------------------------------------XX--X-------------------XX--------------XX-XXX-X----------------------------XXX------------------------------------XX-XXX--
---------X-XX-XXX--------<>-------------------------------E-----------------E-------XXX--XX-----------------XXX-------------XXX-XXX-X---------------------------XXXX------------------------------------XX-XXX--
--------XX-XX-XXX--------[]--------------------------------------------------------XXXX--XXX---------------XXXX------------XXXX-XXX----------------------------XXXXX----------------------------------X-XX-XXX--
-------XXX-XX-XXX--------[]-------------------------------------------------------XXXXX--XXXX------------XXXXXX-----------XXXXX-XXX---------------------------XXXXXX------------------E--------------XX-XX-XXX--
-XXXXXXXXX-XX-XXXXXXXXXXXXXXXXXXXXXXXXXXXXXXXXXXXXXXXXXXXXXXXXXXXXXXXXXXXXXXXXXXXXXXXXXXXXXXXXXXXXXXXXXXXXXXXXX----X--XXXXXXXXX-XXXXXXXXXXXX--X-XXXXXXXXXXXXX-XXXXXX---XXXXXXXXXXXXXXXXXXXXXXXXXXXXXXXX-XX-XXXXX
