----------------------------------------------------------------------------------------------------------------------------------------------------------------------------------------------------------------
----------------------------------------------------------------------------------------------------------------------------------------------------------------------------------------------------------------
----------------------------------------------------------------------------------------------------------------------------------------------------------------------------------------------------------------
----------------SSSSSSSSSSSSSSSSSSSSSSSSSSSSS------------------------------------------------------------------------------------------------------------------------------------------------------------SSSSSSS
----------------------------------------------------------------------------------------------------------------------------------------------------------------------------------------------------------------
----------------------------------------------------------------------------------------------------------------------------------------------------------------------------------------------------------------
----------------------------------------------------------------------------------------------------------X-----------------------------------------XX----------------------------------------------------------
---------------------------------------------------------------------------------------------------------XX----------------------------------------XXX------------X---------------------------------------------
----------------------------------------------------------------------------------------------------E---XXX---------------------------------------XXXX----------------------------------------------------------
----------------XXXXX-----------------------------------------------------------------------------------XXX--------------------------------------XXXXX----------------------------------------------------XXXX--
---------------XXXXXX---------------------------------------------------------------------------------X-XXX-------------------------------------XXXXXX---------------------------------------------------XXXXXX-
--------------XXXXXXX--------------------------------------------------------------------------------XX-XXX-------------------------------------XXXXXX--------------------------------XX--XX------------XXXXXXX-
-------------XXXXXXXX---XXX--------------------------------------------------------------------------XX-XXX-----------------------------------X-XXXXXX-------------------------------XXX---------------XXXXXXXX-
-----X------XXXXXXXXX-------------------------------X--------------------X-------------------------X-XX-XXX----------------------------------XX-XXXXXX------------------------------XXXX-------------XXXXXXXXXX-
XXXXXX-----XXXXXXXXXXXX------------------------XXXXXX-----------XXXXXXXXXX----------XXXXXXXXXXXXXXXX-XX-XXXXXXXXXXXXXXXXXXXXXXXXXXXXXXXXXXXXXXX-XXXXXX----------------XXXXXXXXXXXXXXXXXX---------S---XXXXXXXXXX-
XXXXXX-----XXXXXXXXXXX-------------------------XXXXXX-----------XXXXXXXXXX----------XXXXXXXXXXXXXXXX-XX-XXXXXXXXXXXXXXXXXXXXXXXXXXXXXXXXXXXXXXX-XXXXXX----------------XXXXXXXXXXXXXXXXXX-------------XXXXXXXXXX-
