----------------------------------------------------------------------------------------------------------------------------------------------------------------------------------------------------------------
----------------------------------------------------------------------------------------------------------------------------------------------------------------------------------------------------------------
----------------------------------------------------------------------------------------------------------------------------------------------------------------------------------------------------------------
----------------------------------------------------------------------------------------------------------------------------------------------------------------------------------------------------------------
----------------------------------------------------------------------------------------------------------------------------------------------------------------------------------------------------------------
--------------o----------------------------------------------------------------------------------------------ooooooo-o------------------------------------------------------------------------------------------
----------------------------------XX----------------------------------------------------------------------SSSSSSSSSSSS--------------------------------------------------------------------------------S---------
---------------------------------XXX---------------------------------------------------------------------------------------------------XX------------XX---------------------------------------------------------
--------------------------------XXXX----------------------------------------------------------------------------------------------------------------XXX---------------------------------------------------------
-------------------------------XXXXX----------------------------------------------------------------------------E----------------------------------XXXX----------------------------------------------oooo-------
------------------------------XXXXXX-------------------------------------------------------------------------SSSSSSSSSS---------------------------XXXXX---------------------------------------------XXXXXX------
-----------------------------XXXXXXX----------------------------------------------------XX-------------------------------------------------------XXXXXX---------------------------------------------------------
----------------------------XXXXXXXX-------------------------------------------------------------------------------------------------------------XXXXXX---------------------------------------------------------
---------------------------XXXXXXXXX---------------------------------------------XXXX----------------------------------------------------------X-XXXXXX---------------------------------------------------------
-----------------XXXXXXXXXXXXXXXXXXX--XX---------------XXXXXXXXXXXXX-------------XXXXX-------------XXXXX--XXXXXXXXXXXXX--------------------XXXXX-XXXXXX--XXXXXXXXXXXXXXXXX--------------------------------XXXXX-
-----------------XXXXXXXXXXXXXXXXXXXXXXXXXXXX----------XXXXXXXXXXXXX-------------XXXXX-------------XXXXX--XXXXXXXXXXXXX--------------------XXXXX-XXXXXXXXXXXXXXXXXXXXXXXXX-----X--------------------------XXXXX-
