----------------------------------------------------------------------------------------------------------------------------------------------------------------------------------------------------------------
----------------------------------------------------------------------------------------------------------------------------------------------------------------------------------------------------------------
----------------------------------------------------------------------------------------------------------------------------------------------------------------------------------------------------------------
----------------------------------------------------------------------------------------------------------------------------------------------------------------------------------------------------------------
----------------------------------------------------------------------------------------------------------------------------------------------------------------------------------------------------------------
----------------------------------------------------------------------------------------------------------------------------------------------------------------------------------------------------------------
----------------------------------------------------------------------------------------------------------------------------------SSS?SSS-------------------------------------------------------XXX--------XXX--
----------XX-----------------------------------------------------------------------------------------------------------------------------------------------------------------------------------XXXX--------XXX--
-----E---XXX----------------------------------------------------------------------------------------------------------------------------------------------------------------------------------XXXXX--------XXX--
---------XXX------------------------------------------XSS-------------------------------------------------------------------------------------------------------X-----------------------------XXXXX--------XXX--
-------X-XXX----------------------------XXX----------XX--------------------------------------------------------------------------SSSSSSSS----------------------XX---------------------------X-XXXXX--------XXX--
------XX-XXX-------------XXXXXX---------------------XXX--SS------------XX---------------------------------------E---------------------------------------------XXX--------------------------XX-XXXXX--------XXX--
------XX-XXX------------XX-------------------------XXXX--------------------------------------------------------<>--------------------------------------------XXXX-------------------------XXX-XXXXX--------XXX--
----X-XX-XXX-----------XXX------------------------XXXXX---SSS--------------------------------------------------[]-------------------------------------------XXXXX------------------------XXXX-XXXXX--------XXX--
---XX-XX-XXX--------XXXXXX-----------------------XXXXXX----------------------------------------X-XXXXXXXXXXXXXXXXXXXXXXXXXXXXXXXXXXXXXXXXX-----------------XXXXXX-----------------------XXXXX-XXXXX--------XXX--
XXXXX-XX-XXXXXXXXXXXXXXXXX--------------------X--XXXXXX-----XXXXXXXXXX-------------------------XXXXXXXXXXXXXXXXXXXXXXXXXXXXXXXXXXXXXXXXXXX--------------X--XXXXXX--XXXXXXXXXXXXXXXXXXXXXXXXXX-XXXXXXX------XXX--
