----------------------------------------------------------------------------------------------------------------------------------------------------------------------------------------------------------------
----------------------------------------------------------------------------------------------------------------------------------------------------------------------------------------------------------------
----------------------------------------------------------------------------------------------------------------------------------------------------------------------------------------------------------------
----------------------------------------------------------------------------------------------------------------------------------------------------------------------------------------------------------------
----------------------------------------------------------------------------------------------------------------------------------------------------------------------------------------------------------------
----------------------------------------------------------------------------------------------------------------------------------------------------------------------------------------------------------------
-----------------------------------XX------------------------------------------------------XX---------XX----------------------------------------------------XX-------------------------------XX-----------------
----------------------------------XXX-------E------------------------------XX-------------XXX---------XX---------------------------------------------------XXX--------------------E---------XXX-----------------
---------------------------------XXXX----------------------------------------------------XXXX-------XXXX--------------------------------------------------XXXX-----------------------------XXXX-----------------
--------------------------------XXXXX-----------------------------------------------X---XXXXX-------XXXX-------------------------------------------------XXXXX----------------------------XXXXX-----------------
-----------------XXX-----------XXXXXX-------------------------------------------------XXXXXXX-------XXXX------------------------------------------------XXXXXX---------------------------XXXXXX-----------------
----------------XXXX----------XXXXXXX------------------------------------------------XXXXXXXX-------XXXX------------------------------------------------XXXXXX--------------------------XXXXXXX-----------------
---------------XXXXX----------XXXXXXX-----------------------------------------------XXXXXXXXX-------XXXX------------------------------------------------XXXXXX-------------------------XXXXXXXX-----------------
---------------XXXXX----------XXXXXXX--------------------------X-------------------XXXXXXXXXX-------XXXX-------------------------------------------X----XXXXXX------------------------XXXXXXXXX-----------------
XXXX-----------XXXXXXXXXXXXXXXXXXXXXXXX----------XXXXXXX----XXXX-------------------XXXXXXXXXXX------XXXXXXXXXXXXXXXX---------------XXXXXXXXXXXXXXXXXX---XXXXXX-----------XXXXXXXXXXXXXXXXXXXXXXXXXXXXXXXXXXXXXXX
XXXX-----------XXXXXXXXXXXXXXXXXXXXXXXX----------XXXXXXX----XXXX-------------------XXXXXXXXXXX------XXXXXXXXXXXXXXXX---------------XXXXXXXXXXXXXXXXXX---XXXXXX-----------XXXXXXXXXXXXXXXXXXXXXXXXXXXXXXXXXXXXXXX
