----------------------------------------------------------------------------------------------------------------------------------------------------------------------------------------------------------------
----------------------------------------------------------------------------------------------------------------------------------------------------------------------------------------------------------------
----------------------------------------------------------------------------------------------------------------------------------------------------------------------------------------------------------------
----------------------------------------------------------------------------------------------------------------------------------------------------------------------------------------------------------------
----------------------------------------------------------------------------------------------------------------------------------------------------------------------------------------------------------------
----------------------------------------------------------------------------------------------------------------------------------------------------------------------------------------------------------------
-----XX---------------------------------------------XX----------------------------------------------------------------------------------------------------------------------------------------------------------
----XXX--------------------------------------------XXX-------------------------------E---XX------------------------------------------------------X--------------S-----------------------------------------------
---XXXX-------------------------------------------XXXX-----------------------------------XX-----------------------------------------------------XX--------------------------------------------------------------
--XXXXX------------------------------------------XXXXX-----------------------------------XX------------X----------------------------------------XXX------------------------------------------------------------X
-XXXXXX---------------E-------------------------XXXXXX--------------------------------X--XX-----------XX-------------------------------------X--XXX---------EE--E---------------------------------------------XX
XXXXXXX----------XXXXXXX-----------------------XXXXXXX---QQQQ-------------------------X--XX----------XXX-----------S-------------------------X--XXXXXXXXXXXXXXXXXXXX----------X--X---------------------------XXX
XXXXXXX---------XX----------------------------XXXXXXXX------------------------------X-X--XX---------XXXX------------------------------------XX--XXX----------------X---------XX--XX-------------------------XXXX
XXXXXXX--------XXX---------------------------XXXXXXXXX------------------------------X-X--XX--------XXXXX----------------------------------XXXX--XXX----------------X-----XXXXXX--XXX-----------------------XXXXX
XXXXXXX-------XXXX--------------------------XXXXXXXXXX---------------------------X-XX-X--XX-------XXXXXX--------X------------------------XXXXX--XXX----------------X----XXX---X--XXXX---------------------XXXXXX
XXXXXXXXXXXXXXXXXX-------XXXXXXXXXXX-XXXXXXXXXXXXXXXXXXXXXXXXXXXXXXXXXXXXXXXXXXXXX-XX-X--XXXXXXXXXXXXXXXXXXXXXXXXXXXXXXXXXXXX-XXXXXXXXXXXXXXXX--XXX----------------XXXXXXXX---X--XXXXXXXXXXXXXXXXXXXXXXXXXXXXXXX
