----------------------------------------------------------------------------------------------------------------------------------------------------------------------------------------------------------------
----------------------------------------------------------------------------------------------------------------------------------------------------------------------------------------------------------------
----------------------------------------------------------------------------------------------------------------------------------------------------------------------------------------------------------------
------------------------------------------------------------------------------------------------------------------------SSSSSSSSSSSSSSSSSSSSSSSSSSSSSS----------------------------------------------------------
----------------------------------------------------------------------------------------------------------------------------------------------------------------------------------------------------------------
----------------------------------------------------------------------------------------------------------------------------------------------------------------------------------------------------------------
------------------------------------------------------SSSSSSSS-------------------------------------------------------------------------------------------------------------------------------------XX-----------
--------------------------------------------------------------------------------------------------------------------------------------------------------------XX---------------------------------EXXX-----------
--------------------------------------------------------------------------------------------------------------------------------------------------------------XX---------------------------------XXXX-----------
------------------------------X--------------------------------------------------------------------------------X-----------X----------------------X---------X-XX--------------------------------XXXXX-----------
----------XX-----------------XX------------------------SSSSSSS------------------------SSSSSS------------------------------XX-------------------------------XX-XX-------------------------------XXXXXX-----------
---------XXX----------------XXX------------------------------------------------------------------------------------------XXX------------------------------XXX-XX------------E-----------------XXXXXXX-----------
--------XXXX---------------XXXX-----------------------------------------------------------------------------------------XXXX----XX-----------------------XXXX-XX-----------<>----------------XXXXXXXX-----------
-------XXXXX--------------XXXXX--------------------------E--------------------------------------------------X----------XXXXX----------------------------XXXXX-XX-----------[]----X----------XXXXXXXXX-----------
------XXXXXXXXXXXXXXXXXXXXXXXXXXXXXXXXXXXXXXXXXXXXXXXXXXXXXXXXX-------------XXXXXXXXXXXXXXXXXXXXXXXXXXXXXXXXX---------XXXXXX-----------------------S---XXXXXX-XXXXXXXXXXXXXXXXXXXX-----S---XXXXXXXXXXXXXXXXXXXXX
------XXXXXXXXXXXXXXXXXXXXXXXXXXXXXXXXXXXXXXXXXXXXXXXXXXXXXXXXX--X----------XXXXXXXXXXXXXXXXXXXXXXXXXXXXXXXXX---------XXXXXX---------------------------XXXXXX-XXXXXXXXXXXXXXXXXXXX---------XXXXXXXXXXXXXXXXXXXXX
