----------------------------------------------------------------------------------------------------------------------------------------------------------------------------------------------------------------
----------------------------------------------------------------------------------------------------------------------------------------------------------------------------------------------------------------
----------------------------------------------------------------------------------------------------------------------------------------------------------------------------------------------------------------
----------------------------------------------------------------------------------------------------------------------------------------------------------------------------------------------------------------
--------------------------------------------------------------------------------------------------------------------------------E---------SSSSSSSSSSSSSSSSSSSSSSSSSSSSSSSSSSSSSSSSSSS---------------------------
----------------------------------------------------------------------------------------------------------------------------------------------------------------------------------------------------------------
-------------------------------------SSS------------------------------------------------------------------------------------------------------------------------------------------------------------------------
-------------------------XX-----------------------------------------------------------------------------------SS-----------------XX-----------------------------------------------------------------XXX---------
------------------------XXX-----------------------------------------------------------------------------------------------------XXX------------------------------------------------------------E---XXXX---------
------------------------XXX-----------------------------------------------------------------------------------------------------XXX----------------------------------------------------------------XXXX---------
----------------------X-XXX-----------SSSSSS----------------------------------------------------------------------------------X-XXX--------------------------------------------------------------X-XXXX---------
---------------------XX-XXX---QQQ-----------------------------------------------------------------------------S-S------------XX-XXX----------------------X---------QQQQQ----------X--X----------XX-XXXX---------
---------------------XX-XXX-------------------------------------------------------------------------------------------------XXX-XXX------------------X---X----------------------X-X--X---------XXX-XXXX---------
-------------------X-XX-XXX------------------------------------------------------------------------------------------------XXXX-XXX-----------------XX---X-X----------------X-X-X-X--XX-------XXXX-XXXX---------
------------------XX-XX-XXX-------------oo---------------------------------------------------------------------E----------XXXXX-XXX--------X-------XXX---X-X--------------X-X-X-X-X--XX------XXXXX-XXXX---------
XXXXXXXXXXXXXXXXXXXX-XX-XXXXXXXXXXXXXXXXXXXXX--XXX-XX-XXX--XXX-XXX-XXXXXXXXXXXX-X-XXXX-X-XXXX-XXXXXXXXXXXXXXXXXXXXXXXXXXXXXXXXX-XXXXXXXXXXXXXXXXXXXXXXXXXXXXXXXXXXXXXXXXXXXXXXXXXXXXXXXXXXXXXXXXXX-XXXXXXXXXXXXX
