----------------------------------------------------------------------------------------------------------------------------------------------------------------------------------------------------------------
----------------------------------------------------------------------------------------------------------------------------------------------------------------------------------------------------------------
----------------------------------------------------------------------------------------------------------------------------------------------------------------------------------------------------------------
----------------------------------------------------------------------------------------------------------------------------------------------------------------------------------------------------------------
----------------------------------------------------------------------------------------------------------------------------------------------------------------------------------------------------------------
----------------------------------------------------------------------------------------------------------------------------------------------------------------------------------------------------------------
-------------------------------------------------------XX-----------------------------------------------------------------------------------------------------------------------------------SSSSSSSSSSS---------
------------------------------------------------------XXX-------------------------------------------------------------------------------------------------------------------------------------------------------
-----------------------------------------------------XXXX---------------------------------------------------------------------------------------------------------------------------X---------------------------
----------------------------------------------------XXXXX--------------------------------X-------------------------------XX---------------------------------------------------------X-------------E-------------
------------------SSSSS----------------------------XXXXXX-------------------------------XX------------------------------XXX------------------------------------------------------X--X---------SSSSSSSSS--------X
--------------------------------------------------XXXXXXX---------X--X-----------------XXX---------------------------X--XXX--------------------------------------------XX-----X--X--X-------------------------XX
-------------------------------------------------XXXXXXXX--------XX--XXX--------------XXXX--------------------------XX--XXX------------------E------------------------XXX-----X--X--XX-----------------------XXX
------------------------------------------------XXXXXXXXX-------XXX--XXXX------------XXXXX-------------------------XXX--XXX------------------------------------------XXXX-----X--X--XX----------------------XXXX
------XXXXXXXXXXXXXXXXXX----XXXXXXXXXXXXXXXXXXXXXXXXXXXXX--XXXXXXXX--XXXX-------S---XXXXXX------------------------XXXX--XXX----------------------------------------XXXXXX-----X--X--XXXXXXXXXXXXXXXXXXXXXXXXXXXX
---X--XXXXXXXXXXXXXXXXXX----XXXXXXXXXXXXXXXXXXXXXXXXXXXXXXXXXXXXXXX--XXXX-----------XXXXXX--XXXXXXXXXX-X-X-X----XXXXXX--XXXXXXXXXXXXXXXXXXXXXXXXXXXXX-XXXXXXXXXXXXXXXXXXX-----X--X--XXXXXXXXXXXXXXXXXXXXXXXXXXXX
