----------------------------------------------------------------------------------------------------------------------------------------------------------------------------------------------------------------
----------------------------------------------------------------------------------------------------------------------------------------------------------------------------------------------------------------
----------------------------------------------------------------------------------------------------------------------------------------------------------------------------------------------------------------
--------------------------------------------------------------------------------------SSSSSSSSSSSSSSSSSS----------------------------------SSSSSSSSSSSSSSSSSSSSSSSSSSSSSSS---------------------------------------
SSSSSSSSSSSSSSSSSSSSSSSSSSSSSSSSSSSSSSSSSS---------SSSSSSSSSSSSSSSSSSSSSSSSSSSSSS------------------------------------SSSSSS-----SSSSS----SSS--------------------------SSSSSSSSSS-S--SSSSSSSSSS---SSSSSSSSSSSSSSS
----------SSSS------------------------------------------------------------------------------------------------------------------SSSSS---SSSS--------------------------SSSSSS----------------------SSSSSSS--SS---
----------SSSS------------------------------XX----------------------------------------QQQQQ-------------------------------------SSSSS---SSSS-------------------------SSSSSSSS---------------------SSSSSSS--SSS--
--------------------------------------------------S--------------------------------XX--------------------------------------------SSSS-------------------------------------------------------------SSSSSSS--SS---
---------------------------------------------------------------------------------------------------------------------------------S-SS-----------SSSS------------------------------------------------------------
---------------------------------------------------------------------------------------------E---oooooo---------------------------SSS-----------SSSSS----------oooooo-------------------------------------------
-----------E---------------------------------------------------------------------------SSSSSSSSSSSSSSSSSS-------------------------SSS---SSSSS---SSSSSSSSSSSSSSSSSSSSSSSSSSSSS-----------------------oo----------
----------SSSS------------------------------------------------------------------------SSSSSSSSSSSSSSSSS---------------------------SSS---S-S-------------SSSSSSSSSSSSS---------XX-------------------SSSSSS---SS--
--------------------------------------------------------------------------------------SSSSSSSSSSSSSSSSS----------------------------SS--------<>---------SSSSSSSSSSSSS--------XXX--------------------------------
--------------------------------------------------------------------------------------SSSSSSS--------------------------------------SS--------[]-----------------------------XXXX--------------------------------
-------------------------------E-----------------------E------------------------------XXXXXXXXXXXXXXXXXXXXXXX-XXX---------------------XXXXXXXXXXXXXXXXXXXX-XXXXXXXXXXXXXXXXXXXXX--------------------------------
XXXXXXXXXXXXXX--XXXXXXXXXXXXXXXXXXXX-XX--X--X--XXXXXXXXXXXXXX--XXXXX-XXX-XX-XXX--XX---XXXXXXXXXXXXXXXXXXXXXXXXXXX-XX-XX--XX--X-XXXXXXXXXXXXXXXXXXXXXXXXXXX-XXXXXXXXXXXXXXXXXXXXX-XXXXXXXX-XX--X---XXXXXXXXXXXXXX
