----------------------------------------------------------------------------------------------------------------------------------------------------------------------------------------------------------------
----------------------------------------------------------------------------------------------------------------------------------------------------------------------------------------------------------------
----------------------------------------------------------------------------------------------------------------------------------------------------------------------------------------------------------------
------------SSSSSSSSSSSSSSSSSSSSSSSSSSSSSSSS--------------------------------------------------------------------------------------------------------------------------------------------------------------------
---------S------------------------------------------------------------------------------------------------------------------------------------------------------------------------------------------------------
----------------------------------------------------------------------------------------------------------------------------------------------------------------------------------------------------------------
-------------------------------------------------------------------------------------------------------------------------------------------------------------XX---------------------XX--------------------------
------------------------------------------------------------------------------------------------XX--------------XX------------------------------------------XXX--------------------XXX----XX--------------------
-----------------------------------------------------------------------------------------------------------------------------------------------------------XXXX-------------------XXXX--------------------------
-----------XXXXX----------------------------------------------------------------------------------------------------------------------------------X-------XXXXX------------------XXXXX--------------------------
-----------XXXXX----------------------------------------------------XXXX------------XXXX-----------------------------------XX--------------------XX------XXXXXX-----------------XXXXXX--------------------------
---------XXXXXXX---------XXX----XXX-------------------------------------------------XXXX----------------------------------XXX-------------------XXX-----XXXXXXX----------------XXXXXXX--------------------------
---------XXXXXXX---XX---------------------------------------------------------------XXXX-----E---------------------------XXXX------------------XXXX----XXXXXXXX---------------XXXXXXXXX-------------------------
---X---XXXXXXXXX--------------------------------------------------------------------XXXX----<>--------------------------XXXXX----------X------XXXXX---XXXXXXXXX--------------XXXXXXXXXX-------------------------
XXXX---XXXXXXXXX--------------------------------------------------------------------XXXX----[]--------------------------XXXXXXXXXXXXXXXX-----XXXXXX--XXXXXXXXXXXXXX----XXXXXXXXXXXXXXXXXX-----------------------
XXXX---XXXXXXXXX--------------------------------------------------------------------XXXX----[]--------------------------XXXXXXXXXXXXXXXX-----XXXXXXX-XXXXXXXXXXXXXXX---XXXXXXXXXXXXXXXXXX-----------------------
