----------------------------------------------------------------------------------------------------------------------------------------------------------------------------------------------------------------
----------------------------------------------------------------------------------------------------------------------------------------------------------------------------------------------------------------
----------------------------------------------------------------------------------------------------------------------------------------------------------------------------------------------------------------
----------------------------------------------------------------------------------------------------------------------------------------------------------------------------------------------------------------
----------------------------------------------------------------------------------------------------------------------------------------------------------------------------------------------------------------
----------------------------------------------------------------------------------------------------------------------------------------------------------------------------------------------------------------
----------XXX----------------------------------------------------------------XX-----------S-SS------SSSSS------------------------------------------------------------------------X--------XX--------------------
---------XXXX------------X-------------------------XX-----------------------XXX----XX-------------------------------------------------------------------------------------------XX-------XXX--------------------
---------XXXX------------------------------------EXXX----------------------XXXXXX----------------------------------------------------------------------------------------------XXX------XXXX--------------------
---------XXXX-----------------------B------------XXXX---------------------XXXXX---------------------------------X---------------------------------------------------X---------XXXX-----XXXXX--------------------
-------X-XXXX----------------------XXXXX--------XXXXX--------------------XXXXXX---------------------SSSSSS------XX-------------------------------------------------XX--------XXXXX----XXXXXX--------------------
-------X-XXXX---------------------XXXXXX-------XXXXXX-------------------XXXXXXX---------------------------------XXX-----------------------------------------------XXX-------XXXXXX---XXXXXXX--------------------
-------X-XXXX--------------------XXXXXXX------XXXXXXX------------------XXXXXXXX-E-------------------------------XXXXX--------------------------------------------XXXX------XXXXXXX--XXXXXXXX--------------------
----X--X-XXXX-------------------XXXXXXXX-----XXXXXXXX-----------------XXXXXXXXX<>--------------------------E----XXXXX-------------------------------------------XXXXX-----XXXXXXXX-XXXXXXXXX------------------E-
----X--X-XXXX------------------XXXXXXXXXXXXXXXXXXXXXXXXXXXXXXXXXXXXXXXXXXXXXXXX[]-----------------XXXXXXXXXXXXXXXXXXXXXX------------XXXXX----------------------XXXXXX----XXXXXXXXXXXXXXXXXXXXXXXXXXXXXXXXXXXXXXX
----X--X-XXXX------------------XXXXXXXXXXXXXXXXXXXXXXXXXXXXXXXXXXXXXXXXXXXXXXXX[]-----------------XXXXXXXXXXXXXXXXXXXXXX------------XXXXX----------------------XXXXXX-XX-XXXXXXXXXXXXXXXXXXXXXXXXXXXXXXXXXXXXXXX
