----------------------------------------------------------------------------------------------------------------------------------------------------------------------------------------------------------------
----------------------------------------------------------------------------------------------------------------------------------------------------------------------------------------------------------------
----------------------------------------------------------------------------------------------------------------------------------------------------------------------------------------------------------------
----------------------------------------------------------------------------------------------------------------------------------------------------------------------------------------------------------------
-------------------------------------------------------------------------------------------------------------------------------------------------------------------------------E--------------------------------
-----------------------------------------------------------------------------------------------------------------------------------------------------------------------------------------------------oooo-------
---------------------------------------------------------------------------------------------------------------------------------------------------------------------------------------------------SSSSSSSSSS---
----------------------------------------------------------------------------------------------------------------------------------------------------------------------------E---XX------------------------------
--------------------------------------------------------------------------------------------------------------------------------------------------------------------------------XX------------------------------
------------------X-------------------------------------------------------------------------------------------------------------------------------------------------------------XX------------------------------
-----------------XX------------------------------------------------------XSS-SQ--------------------------------X---------------------EX--------------------------------------X--XX---------------XSSSSSSSSSSS---
XXXX------------XXX-----------------------------------------------------XX------------------------------------XX---X-----------------XX--------------------------------------X--XX--------------XX------------XX
X--------------XXXX--------------------E-------------------------------XXX-----------------------------------XXX---XX---------------XXX------------------------------------X-X--XX-------------XXX------------XX
X-------------XXXXX---------------------------------------------------XXXX----------------------------------XXXX---XXX------------EXXXX-----------------------------------XX-X--XX------------XXXX----------XXXX
X------------XXXXXX--------------------------------------------------XXXXX---SSSS--------------------------XXXXX-E-XXX------------XXXXX----------------------------------XXX-X--XX-----------XXXXXXXXXXXXXXXXXXX
XX-X---XXXXXXXXXXXX--XXXXXXXXXXXXXXXXXXXXXXXXXXXXXXXXX-X---XXX-X-XXXXXXXXX------XXXX-XXXXXXXXXXXXXXXX-XXXXXXXXXXXXXXXXXXX--X---XXXXXXXX--XXXXXXXXX-X-XXXXX-XXXXXXXXXXXXX-XXX-X--XXXXXXXXXXX-XXXXXXXXXXXXXXXXXXXX
