----------------------------------------------------------------------------------------------------------------------------------------------------------------------------------------------------------------
----------------------------------------------------------------------------------------------------------------------------------------------------------------------------------------------------------------
----------------------------------------------------------------------------------------------------------------------------------------------------------------------------------------------------------------
----------------------------------------------------------------------------------------------------------------------------------------------------------------------------------------------------------------
----------------------------------------------------------------------------------------------------------------------------------------------------------------------------------------------------------------
----------------------------------------------------------------------------------------------------------------------------------------------------------------------------------------------------------------
-----SSSSSSSSSS------------------XX-----------------------------------------------------------XX-------XXX----------XX-------------------------------------------------------------------XX---------------------
--------------------------------XXX----------------------------------------------------------XXX-------XXX---------XXX------------------------------------------------------------------XXX----X----------------
-------------------------------XXXX---------------------------------------------------------XXXX-------XXX--------XXXX-----------------------------------------------------------------XXXX--------------------X
------------------------------XXXXX-----------------------------------------------X--------XXXXX-------XXX-------XXXXX----------------------------------------------------------------XXXXX---------------------
------SSSSSSSSSS-------------XXXXXX----------------------------------------------XX-------XXXXXX-------XXX------XXXXXX---------------------------------------------------------------XXXXXX---------------------
----------------------------XXXXXXX---------------------------------------------XXX------XXXXXXX-------XXX-----XXXXXXX------------------------------------XXX-----------------------XXXXXXX---------------------
---------------------------XXXXXXXX--------------------------------------------XXXX-----XXXXXXXX-------XXX-----XXXXXXX-------------------------------------------------------------XXXXXXXX---------------------
--------------------------XXXXXXXXX-------------------------------------------XXXXX----XXXXXXXXX-------XXX---XXXXXXXXX-------------------------------X----------------------------XXXXXXXXX---------------------
XXXXXXXXXXXXXXXX----XXXXXXXXXXXXXXXXXXX-----XXXXXXXXXXXXX-----------------XXXXXXXXXXXXXXXXXXXXXXXX-----XXXX-XXXXXXXXXXXXXXXXXXXXXXXXXXXXXXXXXXXXXXXXXX--------------XXXXXXXX-----XXXXXXXXXX---------------------
XXXXXXXXXXXXXXXX----XXXXXXXXXXXXXXXXXXX-----XXXXXXXXXXXXXX----------------XXXXXXXXXXXXXXXXXXXXXXXX-----XXXX-XXXXXXXXXXXXXXXXXXXXXXXXXXXXXXXXXXXXXXXXXX--------------XXXXXXXX-----XXXXXXXXXXX--------------------
