----------------------------------------------------------------------------------------------------------------------------------------------------------------------------------------------------------------
----------------------------------------------------------------------------------------------------------------------------------------------------------------------------------------------------------------
----------------------------------------------------------------------------------------------------------------------------------------------------------------------------------------------------------------
----------------------------------------------------------------------------------------------------------------------------------------------------------------------------------------------------------------
----------------------------------------------------------------------------------------------------------------------------------------------------------------------------------------------------------------
----------------------------------------------------------------------------------------------------------------------------------------------------------------------------------------------------------------
----------------------------------------------------------------------------------------------------------------------------------------------------------------------------------------------------------------
-----------XX---------------X-------------------------------------------------------------------------------------------------------------------------------XX----------------XX--------------------------------
-----------XX--------------XX------------------------------------------------------------------------------------------------------------------------------XXX---------------XXX--------------------------------
-----------XX-------------XXX----------------------oo-----------------------------------------------------------------------------oo---------XX-----------XXXX-------------XXXXX--------------------------------
--------X--XX-------------XXX---------------------------------------------------------------------------------------------------------------XXX--o-------XXXXX------------XXXXXX--------------------------------
-------XX--XX-----------XXXXX------------------XX-----------------------------------------------------------------------------XXX----------XXXX---------XXXXXX-----------XXXXXXX----------------------------X---
-------XX--XX-----------XXXXX-----------------XXX--------------------------------------------------------------------E-------XXXX---------XXXXX--------XXXXXXX----------XXXXXXXX---------------------------XX---
-----X-XX--XX-----------XXXXX----------------XXXX---------------------------------------------------------------------------XXXXX--------XXXXXX-------XXXXXXXX---------XXXXXXXXX--------------------------XXX---
----XX-XX--XX-----------XXXXX---------------XXXXX--------------------------------------------------------------------------XXXXXXX------XXXXXXX------XXXXXXXXX--------XXXXXXXXXX-------X-----------------XXXX---
XXXXXX-XX--XXXXXXXXXXXXXXXXXXXXXXXXXXXX--XXXXXXXX---XXXXXXXX----------------------------------XXXXXXXXXXXXXXXXXXXXXXXXXXXXXXXXXXXXXXXXXXXXXXXXXXXXXXXXXXXXXXXXXXXXXXXXXXXXXXXXXXXXXXXXXXXXXXXXXXXXXXXXXXXXXXXXXX
