----------------------------------------------------------------------------------------------------------------------------------------------------------------------------------------------------------------
----------------------------------------------------------------------------------------------------------------------------------------------------------------------------------------------------------------
----------------------------------------------------------------------------------------------------------------------------------------------------------------------------------------------------------------
----------------------------------------------------------------------------------------------------------------------------------------------------------------------------------------------------------------
--------------------------------------------------------------------------------------------------------------------------E------------E------------------------------------------------------------------------
----------------------------------------------------------------------------------------------------------------------------------------------------------------------------------------------------------------
----------------------------------------------------------------------------------------------------------------------------------------------------------------------------------------------------------------
---------------------------------------------------------------------------------------------------------------------------XX-------E---XX----------------------------------------------------------------------
--------------------------------------------------------------------------------------------------------------------------XXX-----------XX----------------------------------------------------------------------
--------------------X-------------------------------------------------------------X--------------------------------------XXXX-----------XX----------------------------------------------------------------------
-------------------XX-----------------------XX-----------------------------------XX--------------------------------------XXXX--------X--XX--------------------------SSSSSS--------------------------------------
---------------XX--XX-------QQQQ-----------XXX--------------------Q-------------XXX------------------------------------X-XXXX--------X--XX---QQQQQ--------------------------------------------------------------
--------------XXX--XXX--------------------XXXX--------------------------E------XXXX----------------------------E-------X-XXXX------X-X--XX----------------------------------------------E-----------------------
-------------XXXX--XXX-------------------XXXXX--------------------------------XXXXX----------------------------------XXX-XXXX-----XX-X--XX----------------------------------------------------------------------
------------XXXXX--XXX------------------XXXXXX-------------------------------XXXXXX---------------------------------XXXX-XXXX----XXX-X--XX----------------------------------------------------------------------
XXXXXXXXXXXXXXXXX--XXXXXXXXXXXXXXX----XXXXXXXXXXXXX--X----XXXXXXXXXXXXXXXXXXXXXXXXX---XXXXX--X-X---X---XXXXXXXXXX-XXXXXX-XXXXXXXXXXX-X--XXXXXXXXXXXXXXXXXXXXX-X-XXXXXXXXXXXXXXXXXXXXXXXXXXXXXXXXXXXX---XXXXXXXXX
