----------------------------------------------------------------------------------------------------------------------------------------------------------------------------------------------------------------
----------------------------------------------------------------------------------------------------------------------------------------------------------------------------------------------------------------
----------------------------------------------------------------------------------------------------------------------------------------------------------------------------------------------------------------
----------------------------------------------------------------------------------------------------------------------------------------------------------------------------------------------------------------
--------------------------------------------------------------------------------------------------------------------------E----------------------------------------------------------SSSSSSSSSSS----------------
----------------------------------------------------------------------------------------------------------------------------------------------------------------------------------------------------------------
------------XX-------------------------------------------------------------------------------------------------------------------------------------------------------------------------------------X------------
-----------XXX----------------------------XX-----------------------------------------------XX------------------------------XX-----------------------------------------------------------------------------------
----------XXXX-------------X-------------XXX----------------------------------------------XXX-----------------------------XXX-----------------------------------------------------------------------------------
---------XXXXX------------XX------------XXXX----------------------------------------------XXX----------------------------XXXX-----------------------------------------------------------------------------------
--------XXXXXX-----------XXX-----------XXXXX--------------------------------------------X-XXX----------------------------XXXX-----------------------------------------------------------------------------------
-------XXXXXXX----------XXXX----------XXXXXX---S----------------------------------------X-XXX--------------------------X-XXXX------------------XXXXXXXXXXXXXXXXXX-----------------------------XX----------------
------XXXXXXXX--------X-XXXX---------XXXXXXX-------------------------------------------XX-XXX-------------------------XX-XXXX---------------------------------------------------------------EXXX--XXX-----------
-----XXXXXXXXX-------XX-XXXX--------XXXXXXXX------------------------------------------XXX-XXX------------------------XXX-XXXX-------------------------------------XXXXXXX-------------------XXXX----------------
----XXXXXXXXXX--------X-XXXX-------XXXXXXXXX--------X-------------------------------XXXXX-XXX-----------------------XXXX-XXXX-------------------------------------X------------------------XXXXX----------------
XXXXXXXXXXXXXXXXXXXXXXXXXXXXXXXXXXXXXXXXXXXXXXXXXXXXXXXXXXXXXXXXXXXXXXXXXXXXXXXXXXXXXXXXX-XXXXXXXXXXXXX-X-XXXX---XXXXXXX-XXXXXXXXX-X------------------------------X----------------XXXXXXXXXXXXX-------X--------
