----------------------------------------------------------------------------------------------------------------------------------------------------------------------------------------------------------------
----------------------------------------------------------------------------------------------------------------------------------------------------------------------------------------------------------------
----------------------------------------------------------------------------------------------------------------------------------------------------------------------------------------------------------------
----------------------------------------------------------------------------------------------------------------------------------------------------------------------------------------------------------------
-------------------------------------------------------------------------------------------------------------------SSSSSSSSSSSSSSSSSSSSSSSSSSSSSSSSSSSSSSSSSSSSSSSSSSSSSSSSSSSSSSS------------------------------
----------------------------------------------------------------------------------------------------------------------------------------------------------------------------------------------------------------
------------------------------------------------------------------------------------------------------------------------------------------------------------------------------------XXX-------------------------
-------------XX-------------XX-------------------------XX----------------SSSS-------------------------------------------------------------------------------------------------------------SS--------------------
-------------XX------------XXX-----------------------XXXX-------------------------------------------------------------------------------------------------------------------------------------------------------
-----------X-XX----------EXXXX-----------------------XXXX-------------------------------------------------------------------------------------------------------------------------------------------------------
----------XX-XX----------XXXXX---------------------X-XXXX----------------ooo-------------------------------------------------------------------------------------------------------------S----------------------
---------XXX-XX---------XXXXXX---SQQ--------------XX-XXXX---S------------SSSS-S----------------------SS-------------------XX------------------------------------X--X----------------------------------XX--------
--------XXXX-XX--------XXXXXXX-------------------XXX-XXXX---------------------------------------------------------------EXXX-------E---------------------------XX--XX------X--XX-X--XXX------------E-XXX--------
-------XXXXX-XX-------XXXXXXXX------------------XXXX-XXXX--------------------------------------------------------------EXXXX------<>------------------------E-XXX--XXX-----X--XX-X------------------XXXX--------
------XXXXXX-XX------XXXXXXXXX-----------------XXXXX-XXXX--------X-----------------------------------------------------XXXXX------[]-----------------------E-XXXX--XX------X--XX-X-----------------XXXXX--------
XXXXXXXXXXXX-XXXXXXXXXXXXXXXXXXXXXXXXX-X-X--XXXXXXXX-XXXXXXXXXXXXXXXX----XXXXXXXXXXXXXXXXXXXXXXXX--XXXXXXXXXXX-XX-XXXXXXXXXX---XXXXXXXXX-X-----XXXXXXXXXXXXXXXXXX--XXX--XXXXX-XXXX-------XXXXXXXXXXXXXXXXXXXXXXX
