----------------------------------------------------------------------------------------------------------------------------------------------------------------------------------------------------------------
----------------------------------------------------------------------------------------------------------------------------------------------------------------------------------------------------------------
----------------------------------------------------------------------------------------------------------------------------------------------------------------------------------------------------------------
----------------------------------------------------------------------------------------------------------------------------------------------------------------------------------------------------------------
------------------------------------------------------------------------------------------------------------------------------------E---------------------SSSSSSSSSSSSSSSSSSSSSSSSSSSS--------------------------
----------------------------------------------------------------------------------------------------------------------------------------------------------------------------------------------------------------
----------------------------------------------------------------------------------------------------------------------------------------------------------------------------------------------------------------
----------------------------------------------------------------XX-------------------------------------------------------------------XX-------------------------------------------------------------------------
-----------------------------------------------------------E---XXX--------------------------------------------------------------E---XXX-------------------------------------------------------------------------
-----------------XX--------------------------------------------XXX------------------------------------------------------------------XXX-------------------------------------------------------------------------
-------------X--XXX------------------------------------------X-XXX---------------------------------------------------SSSS---------X-XXX-------------------------------------------------------------------------
X------------X--XXX-----------------------------------------XX-XXX------------------------------------------XX-------------------XX-XXX---SQ-----------------------------------XX--X----------------------------
X----------XXX--XXX-------------------------------------E---XX-XXX-----------------------------------------XXX-------------------XX-XXX--------------------------------------EXXX--XX---------------------------
XX--------XXXX--XXX------------------------------------<>-X-XX-XXX--------------------X-------------------XXXX----------------XX-XX-XXX----------X--------------------------EXXXX--XXX--------------------------
XXE------XXXXX--XXX------------------------------------[]XX-XX-XXX--------------E-E---X-----------------XXXXXX---------------XXX-XX-XXX----------X--------------------------XXXXX--XXXX-------------------------
XXXXXXXXXXXXXX--XXXXXXXXXXXXXXXXXXXXXXXXXXXXXXXXXXXXXXXXXXX-XX-XXXXXXXXXXXX-XXXXXXXXXXXXXXXXXXXXXXXXXXXXXXXXXXXXXXXXXXXXXXXXXXXX-XX-XXXXXXXXXXXXXXXXXXXXXXXXXXX-XXXXX--XXXXXXXXXX--XXXXXX-X-X-XXXXX-XX-XXXXXXXXX
