----------------------------------------------------------------------------------------------------------------------------------------------------------------------------------------------------------------
----------------------------------------------------------------------------------------------------------------------------------------------------------------------------------------------------------------
----------------------------------------------------------------------------------------------------------------------------------------------------------------------------------------------------------------
----------------------------------------------------------------------------------------------------------------------------------------------------------------------------------------------------------------
----------------------------------------------------------------------------------------------------------------------------------------------------------------------------------------------------------------
----------------------------------------------------------------------------------------------------------------------------------------------------------------------------------------------------------------
------------------------------------------------------------------------------------------------------------------------------SSSSSSSS----------XX-------------------------------------------SSSSSSSSSS---------
--------------------------------------------------------XX----------------------------------------XX-------------------------------------------XXX--------------------------------------------------------------
-------------------------------------------------------XXX---------------------------------------XXX------------------------------------------XXXX--------------------------------------------------------------
X-----------X-----------------------------------------XXXX---------------------------------------XXX-----------X----------B-E----------------XXXXX--------------------------------------------------------------
X----------XX-----------------------------------------XXXX----------------------------X----------XXX----------XX---------XXXXSSSSSSSSS------XXXXXX--------------------------------------------XSSSSSSSS---------
X---------XXX---------------------------------------XXXXXX---------------------------XX-------X--XXX---------XXX--------XXXXX--------------XXXXXXX----------------X----------XXX--------------X-----------XX----
X--------XXXX---------------------------------------XXXXXX--------------------------XXX------XX--XXX--------XXXX-------XXXXXX-------------XXXXXXXX----------------X---------XXXX-------------XX-----------XX----
X-------XXXXX---------------------------------------XXXXXX-------------------------XXXX-----XXX--XXX-------XXXXX------XXXXXXX-------E----XXXXXXXXX----------------X--------XXXXX------------XXX-----E----XXX----
X------XXXXXX-----------------------------------E---XXXXXX------------------------XXXXX----XXXX--XXX------XXXXXX-----XXXXXXXXXXX-XX<>XXXXXXXXXXXXX----------------XX------XXXXXXX---------XXXXXXXXXXXXXXXXXX----
XX---X-XXXXXX-----XX-XXXXX-X--XXXXXXXXXXXXXXXXXXXXXXXXXXXXXXXXXXXXXXXXXXXXXXXXXXXXXXXXXXXXXXXXX--XXXXXXXXXXXXXXXXXXXXXXXXXXXXXXXXXX[]XXXXXXXXXXXXXXXXXXXXXXXXXXXXXXXXXXXXXXXXXXXX--XX-----XXXXXXXXXXXXXXXXXXXXXX
