----------------------------------------------------------------------------------------------------------------------------------------------------------------------------------------------------------------
----------------------------------------------------------------------------------------------------------------------------------------------------------------------------------------------------------------
----------------------------------------------------------------------------------------------------------------------------------------------------------------------------------------------------------------
----------------------------------------------------------------------------------------------------------------------------------------------------------------------------------------------------------------
----------------------------------------------------------------------------------------------------------------------------------------------------------------------------------------------------------------
----------------------------------------------------------------------------------------------------------------------------------------------------------------------------------------------------------------
----------------------------------------------------------------------------------------------------------------------------------------------------------------------------------------------------------------
----------------------------------------------------------------------------------------------------------------------------------------------------------------------------------------------------------X-----
---------------------------------------------------------------------------------------------------------------------------------------------------------------------------------------------------------XX-----
------------------------------------------------------------------------------------X-------------------------------------------------------------------------------------------------------------------XXX-----
---------------------------------------------------------------XXX-----------------XXX----------------XXXXXXXXXX---------------------------------------------------------------------------------------XXXX-----
-----XXXXXXXX-------------------------------------------------XXXX-----------------XXXX---------------------------------------------------------------------------------------------------------------XXXXX-----
-----X-------------------------------------------------------XXXXX-----------------XXXXX----------------------------------------------E--------------------------------------------------------------XXXXXX-----
---XXX----------XX------X-------------------X---------------XXXXXX-----------------XXXXXX----------------------------XXXXXXXXXXXXXXXXXXXXXXX--------------------------------------------------------XXXXXXX-----
XXXXXX----------X-------XX--XXXXXXXXXXXXXXXXX---------------XXXXXX--XXXXXXXXXXX----XXXXXXX---------------------X-----X---------------------X---------------------XXX------------------XXXXXXXXXXXXXXXXXXXXXXXXXX
XXXXXX----------X-------XX--XXXXXXXXXXXXXXXXX---------------XXXXXX-----------------XXXXXXX---------------------------X---------------------X---------------------XXX------------------XXXXXXXXXXXXXXXXXXXXXXXXXX
