----------------------------------------------------------------------------------------------------------------------------------------------------------------------------------------------------------------
----------------------------------------------------------------------------------------------------------------------------------------------------------------------------------------------------------------
----------------------------------------------------------------------------------------------------------------------------------------------------------------------------------------------------------------
--------------------------------------------------------------------------------------------------------------------------------------------SSSSSSSSSSSSSSSSSSSSSS----------------------------------------------
---------------------------------------------------E------------------------------------------------------------------------------------------------------------------------------------------------------------
---------------------------------------------------------------X------------------------------------------------------------------------------------------------------------------------------------------------
---------------------------------------------------------------XX-----------------------------------------------------------------------------------------------------------------------------------------------
---------------------------XX--------S--------------XX---------XX--------------------S--------------------------SS----------------------------------------------------------------------------------------------
--------------------------XXX----------------------XXX---------XX-----------------------------------------------------------------------------------------------------------------------------------------------
-----X-------------------XXXX---------------------XXXX---------XX----------------------------------------------------------------------XX-----------------------------------------------------------------------
----XX-------------------XXXX---------------------XXXX---------XX---------------------------------------------------------------------XXX-----------------------------------------------------------------------
-X--XX-----------------X-XXXX-------------------X-XXXX---SSS---XX--------------X---XXX------------------------XXXX-----------------X--XXX-----------------------------------------------XXX---------------------
XX--XX-----------------X-XXXX-------------------X-XXXX---------XX-------------XXXXXX-------------------------XX------------------EXX--XXX-----------------------------------------------------------------------
XX--XX---------------X-X-XXXX-----------------X-X-XXXX---------XX------------XXXXX---------------------------XX------------------XXX--XXX--------------------X--------------------------------------------------
XX--XX--------------XX-X-XXXX----------------XX-X-XXXX---------XX-----------XXXX--------------------------E--XX-----------------XXXX--XXX-----------------XXXX--------------------------------------------------
XX--XXXXXXXXXXXXXXXXXX-X-XXXXXXXXXXXXXX---XXXXX-X-XXXXXXXXXXXXXXXXXXXXXXXXXXXXXX-----XXX-XXXXX-----X---XXXXXXXX------XXXXXXXXXXXXXXX--XXXXXXXXXXXXXXXXXXXXXXXX--------------------------------------------------
