----------------------------------------------------------------------------------------------------------------------------------------------------------------------------------------------------------------
----------------------------------------------------------------------------------------------------------------------------------------------------------------------------------------------------------------
----------------------------------------------------------------------------------------------------------------------------------------------------------------------------------------------------------------
----------------------------------------------------------------------------------------------------------------------------------------------------------------------------------------------------------------
----------------------------------------------------------------------------------------------------------------------------------------------------------------------------------------------------------------
----------------------------------------------------------------------------------------------------------------------------------------------------------------------------------------------------------------
------------------------------------------------------------------XX------------------------------------------------------------------------------------------------------------------------XX------------------
------------------------------------------------------------------XX-----------------------------------------------------------------XX----------------------------------------------------XXX------E-----------
----------------------------------------------------------------X-XX----------------------------------------------------------------XXX---------------------------------------------------XXXX------------------
----------------------------------------------------------------X-XX---------------------------------------------------------------XXXX--------------------------------------------------XXXXX------------------
--------XX------------------------------------------------------X-XX--------------------------------------E-----------------------XXXXX-------------------------------------------------XXXXXX------------------
--------XXX--------------------------------------------------X--X-XX---------XXXXXXXXXXXXXXXXXXXXXXXXXXXXXXX---------------------XXXXXX-----------------E------------------------------XXXXXXX------------------
--------XXXX-------------------------------------------------X--X-XX--------XX-----------------------------X--------------------XXXXXXX-----------------------------------------------XXXXXXXX------------------
--X-----XXXX-------------------------------------------------X--X-XX-------XXX-----------------------------X-------------------XXXXXXXX---------------------X------------------------XXXXXXXXX------------------
XXX-----XXXX---XX---XXXXXXXXXXXXXXXXXXXXXXXXXXXXX----------X-X--X-XXXXXXXXXXXX-----------------------------X--XXXXXXXXXXXXXXXXXXXXXXXXXXXXXXXXXXXXXXXXXXXXXXX-------------XXXXXXXXXXXXXXXXXXXX-------------XXXXX
XXX-----XXXX---XX---XXXXXXXXXXXXXXXXXXXXXXXXXXXXX----------X-X--X-XXXXXXXXXXXX-----------------------------X--XXXXXXXXXXXXXXXXXXXXXXXXXXXXXXXXXXXXXXXXXXXXXXX-------------XXXXXXXXXXXXXXXXXXXX-------------XXXXX
