----------------------------------------------------------------------------------------------------------------------------------------------------------------------------------------------------------------
----------------------------------------------------------------------------------------------------------------------------------------------------------------------------------------------------------------
----------------------------------------------------------------------------------------------------------------------------------------------------------------------------------------------------------------
--------------------------------------------------------------------------------------------------------------------------------------------------SSSSSSSSSSSSSSSSSSSSSSSSSSS-----------------------------------
----------------------------------------------------------------------------------------------------------------------------------------------------------------------------------------------------------------
----------------------------------------------------------------------------------------------------------------------------------------------------------------------------------------------------------------
----------------------------------------------------------------------------------------------------------------------------------------------------------------------------------------------------------------
-------XX-------------------------------------------------------XX-----XX------------------------------------------------------------------------------------------------------------------------------X--------
-----XXXX-----------------------------------------------------------------------------------------------------------------------------------------------------------------------XXX-----------------------------
-----XXXX-------------------------------------------------------------------------------------------------------------------------------------------------------------------------------------------------------
---X-XXXX----------------------------E------------------------------------------------------------------------------------------------------------------------------------XXX-----------------------------------
---X-XXXX-----------------------------------XX--XXX--------------------------------------------XX---XXX---------------E-----------------------------------------------------------------------------------------
--XX-XXXX---------------------X------------XXX-E----------------------------------------------XXX--------------------<>-----------------------------------------------------------------------------------------
-XXX-XXXX------------------X--------------XXXX-----------------------------------------------XXXX--------------------[]------X-----------------------------------------X----------------------------------------
XXXX-XXXXXXXXXXXXXXXXXXXXXXX-------------XXXXX--------------------------------XXXXXXX----XXXXXXXX-----------XXXXXXXXXXXXXXXXXX--------------XXXXXXXXX--XXXXXXXXXXXXXXXXX------------XXXXXXX-----------------XXXX
XXXX-XXXXXXXXXXXXXXXXXXXXXXX-------------XXXXX--------------------------------XXXXXXX----XXXXXXXX-----------XXXXXXXXXXXXXXXXXX--------------XXXXXXXXX--XXXXXXXXXXXXXXXXX-----------XXXXXXXX-----------------XXXX
