----------------------------------------------------------------------------------------------------------------------------------------------------------------------------------------------------------------
----------------------------------------------------------------------------------------------------------------------------------------------------------------------------------------------------------------
----------------------------------------------------------------------------------------------------------------------------------------------------------------------------------------------------------------
----------------------------------------------------------------------------------------------------------------------------------------------------------------------------------------------------------------
----------------------------------------------------------------------------------------------------------------------------------------------------------------------------------------------------------------
----------------------------------------------------------------------------------------------------------------------------------------------------------------------------------------------------------------
--------------------------------------------------------------------------------------------------------------------------------X-----------------------------------XX-------XXX--------------------------------
-XX-----------------------------------------------------------------------------------------------------------------------E----XX----------------------------------XXX-------XXX--------------XXX---------------
XXX-----------------------------------------------------------------------------------------------------------------------E---XXX---------------------------------XXXX-------XXX--------------XXX---------------
XXX---------------------------------------------------------------------------------------------------------------------------XXX--------------------------------XXXXX-------XXX--------------XXX---------------
XXX------------------------------------------X-------XX--------------------------------------------------------------------XX-XXX-------------------------------XXXXXX-------XXX------------X-XXX---------------
XXX-----------------------------------------XX------XXX--------------XX--XXX-----------------------------------------------XX-XXX---QQQQ------------------------XXXXXX-------XXX-----------XX-XXX---------------
XXX----------------------------------------XXX-----XXXX-------------XXX-E------------------------------------------------X-XX-XXX-------------------------------XXXXXX-------XXX-----------XX-XXX---------------
XXX----------------XX---------------------XXXX----XXXXX------------XXXX--------------------------------X-----------------X-XX-XXX-----------------XX------------XXXXXX-------XXX--------XX-XX-XXX---------------
XXX--------XXXXXXXXXX--------------------XXXXX---XXXXXX----------XXXXXX--------------------X---X---XXXXX------------X---XX-XX-XXX--------XXX--XXXXXX------------XXXXXX-------XXX--------XX-XX-XXX----X-XXXX-XXXX
XXXXXXXXXXXXXXXXXXXXX--XXX--XXXXXXXXXXXXXXXXXXXXXXXXXXXXXXXXXXXXXXXXXXX----------------XXXXXXXXXXXXXXXXX----------X-XXXXXX-XX-XXXXXXXXXXXXXXXXXXXXXX------------XXXXXX-------XXXXXXXXXXXXX-XX-XXXXXXXXXXXXXXXXXX
