------------------------------------------------------------------------------------------------------------------------------------------------------
------------------------------------------------------------------------------------------------------------------------------------------------------
------------------------------------------------------------------------------------------------------------------------------------------------------
------------------------------------------------------------------------------------------------------------------------------------------------------
------------------------------------------------------------------------------------------------------------------------------------------------------
----------------------------------------------------------------------------------------------------------------------------------------E-------------
------------------E-------------------------------XX-----------------------------------------------------------------------?QQQQQQ---------SSSSSSSSSSS
-----------------<>-------------------------------XX--------------------------------------------------------<>----------------------------------------
-----------------[]----------------------------X--XX--------------------------------------------------------[]----------------------------------------
----------SSS----XX---------------------------XX--XX----------------------X-------------------------ooo-----XX------------------------------------E---
B------------------------------------E----E--XXX--XX----------------------X-----------------------------------------QQQ?---S---------------------<>---
b-------------------B---<>-----B------------XXXX----------------------SSSSX----------------------------------------------------------------------[]---
?-E---------------------[]-----------------XXXXX------------X------------------------------E-----------------------------------------------------[]---
XXXXXXXXXXXXXXXXXXXXXXXXXXXXXXXXXXXXXXXXXXXXXXXXXXXXXXXXXXXXXXXXXXXXXXXXXXXXXXXXXXXXXXXXXXXXXXXXXXXXXXX--XXXXXXX------------EE-------------------[]---
