------------------------------------------------------------------------------------------------------------------------------------------------------
------------------------------------------------------------------------------------------------------------------------------------------------------
----------------------------------------------------SSSSSSSSSSSSSSSSSSSSSSSSSSSSSSSSSSSSSSSSSSSSSSSSSSS----------SSSSSSSSSSSSSSSSSSSSSS-----SSSSSSSSS-
-----------------------------------------------------------------SSSSSSSSSSSSSSSSSSSSSSSSSSSSS---------------------------------------[]---------------
-----------------------------------------------------------------SSSSSSSSSSSSSSSSSSSSSSSSSSSSS-----------XXX-------------------------[]---------------
----------------------------------XX-----------------------------SSSSSSSSSSSSSSSSSSSSSSSSSSSSS--QQ------------SSS--------E---E-------[]---------------
----------------------------------XX-------------------------------------------------------------------------------------------------[]-------SSSSSSS-
--------------------------------XXXX--------------------------------------------------------------------------S----------------------[]-------SSSSSSS-
?-------------------------------XXXX-------------------------------------?-----------------------------------S-S----------SSS--------[]-------SSSSSS--
??SS--------------------------XXXXXX----S--------------------------SSSSSS??SSSSSSSSSSSSSSSSSSS--QQ--QQQ---------S-------<>-----------[]------?SSSSSSQ-
----S-------------------------XXXXXX-------------------------------SSSSS---SSSSSSSSSSSSSSSSSSS------------------------<>[]-----------<>---------------
----S-------------------------XXXXXX-------------------------------SSSSS---SSSSSSSSSSSSSSSSSSS------------------------[][]----------------------------
Q---S-------------------------XXXXXX---------X--------------------------oooSSSSSSSSSSSSSSSSSSS------------------------[][]----------------------------
XX--X--XXXXXXXX---XXX--XXXXXXXXXXXXXXXXXXXXXXXXXXXXXXXXX--XX--X---XXXXXXXXXXXXXXXXXXXXXXXXXXXXXXXXXXXXX------XXXXXXXXXXXXXXXXXXXEXXXXXXX----XXXXXXXXX-
