------------------------------------------------------------------------------------------------------------------------------------------------------
------------------------------------------------------------------------------------------------------------------------------------------------------
-----------------------------------------------------------------------------------------------------E------------------------------------------------
-------------------------------------------------------------------------------------------------------------------------------------------------?----
----------------------------------------------------------------------------------------------------------------------------XX------------------------
----SSSSSS--------------------SSS----------------------------------------------------------XXX--------------------------------------------ooo---------
--------------------------------------------E---------------------------------------------XXXX----------------------------E----------o----ooo------E--
-------------<>----------------------------<>------------------------o------XX-----------EXXXX------------------------XXXXXX-------------------XXXXXX-
-----o-------[]----------------------------[]-------------------------E-----XX----------XXXXXX---------------------------------XXX--------------------
X---S?SS----QQQQQQ------------SSSSSSSSS----XX----------------------SSSSS----XX---------XXXXXXX---------------------------------------------XXXX-----oo
>---SSS--------------------------------------------------------E---E-------XXX-------EXXXXXXXX--------------------XXXXX-------------------------------
]---SS----------------------------------------B---<>-----B-------------E---XXX-------XXXXXXXXX------------------------------------------------XXXXXXXX
]-----E-EE------------E---------------------------[]-----------------------XXX------XXXXXXXXXX-------XX-----------------------------XXXXXXX-----------
XXXXXX-XXXXXXX-X-XXXXXXXXXXXXXXXXXXXXXX---XXXXXXXXXXXXXXXXXXXXXXXXXXXXXXXXXXXX---XXXXXXXXXXXXXXXXXXXXXXXXXXXXXXX--------------XXX---------------------
