------------------------------------------------------------------------------------------------------------------------------------------------------
------------------------------------------------------------------------------------------------------------------------------------------------------
------------------------------------------------------------------------------------------------------------------------------------------------------
------------------------------------------------------------------------------------------------------------------------------------------------------
------------------------------------------------------------------------------------------------------------------------------------------------------
-----------------SSSS--XSX-------------------S------------------------------------QQQ-----------------------------------------------------------------
--------------------------------------------------------oooo----------oooo----------------------------------------------------------------------------
B-----------------------------------------------------------------------------------------------------------------------------------------------------
b-----------------E-----------------------------------------------------------------------------------------------------------------------------------
oo--------------SSSSSSSSSSS----------------QQQQ--------------------<>-----------QQ?-------------------------------------------------------------------
----------<>------------------------------------------X------------[]-------------------------------------B-----------------E--------B---?QQ----------
----------[]------------------------------------------X------------[]-------------------------------------b--------------------------b----------------
----------[]------------------------------------------X------------[]-----------------------E-------------BEE-----------------------------------------
XXXXXXX--XXXXXXXXXXXXXXXXXXXXXXXX---XXXXXXXXXXXXXXXXXXXXXXXXXXXXXXXXXXXXXXXXXXXXXXX--XXXXXXXXXXXXXXXXXXXXXXXXXXXXXXXXXXXXXXXXXXXXXXXXXXXXXXXXXXXXXXXXX
