------------------------------------------------------------------------------------------------------------------------------------------------------
------------------------------------------------------------------------------------------------------------------------------------------------------
-----------------------------------------------------------E------------------------------------------------------------------------------------------
------------------------------------------------------------------------------------------------------------------------------------------------------
--------------------------------------------------------------------------------------------E---------------------------------------------------------
---------------------------------------------------SSSSSSSS?S--------S----S---------------------------------SSSSSS----------XSXXXXXXXXXXXXXX----------
---------------------ES--------------E--------------[]-------------------------------S--------<>--------------------------------[]-------[]-----------
-----B--------S------------QQQ------<>--------------[]----------------------------------------[]--------------------------------[]-------[]-----------
Q----b------------------------------[]--------------[]----------------------------------------[]--------B-----------------------[]-------[]-----------
----XXX--S-----------------------QQQQQQQQQQ---------[]---------------<>-----------------X-----XX-------XXXXESSSSSS--------------[]-------[]-----------
E--XXXX---------------------------------------------<>---------------[]---------E---------------------XXXXXX--------------------<>-------<>-----------
--XXXXX---------B----------------------------------------------------[]--------<>--------------------XXXXXXX------------------------------------------
-XXXXXX---------b-------------B----------------------E---------------[]--------[]-----X-------------XXXXXXXX----------B----------E--------E-----------
XXXXXXXXXXXXXXXXXXXXXXXXXXXXXXX--XXXXXEEXXXXXXXXXXXXXXXXXXXXXXXXXXXXXXXXXXXXXXXXXXXXXXX-------------XXXXXXXXXXXXXXXEXXXXXXXXXXXXXX-XXXXXXXX-XXXEXXXXXX
