------------------------------------------------------------------------------------------------------------------------------------------------------
------------------------------------------------------------------------------------------------------------------------------------------------------
------------------------------------------------------------------------------------------------------------------------------------------------------
------------------------------------------------------------------------------------------------------------------------------------------------------
------------------------------------------------------------------------------------------------------------------------------------------------------
-----------------------------------XX----------------------------E-------------XX-----------------------------------------------------SSSSSSSSSSSSS---
-----------------------------------[]---------------------------<>------------XXX--------------ES------E----------------------------------------------
--------------oo--o----------------[]---------------------------[]-----------XXXX--------------------QQQQ---------------------------------------------
-----------------------------------[]---------------------------[]----------XXXXX--------------------------------Q--Q-?--------------------SSSSS------
-----------------------------------<>SSSSSS-----------------E--S[]SS-------XXXXXX--------------------------<>---------------S------------SS----------Q
--XX<>XXXXXXXXXXX----------XX------------------------------<>---------E---XXXXXXX--------]-----------------[]-------------E------------<>-------------
-XXX[]X--------------------X-X------E--------------------------------<>-XXXXXXXXX-------B]-----------------[]---------E----------------[]-------------
XXX--]X------------XXXXX---X-XXX------E------------------------------[]-XXXXXXXXX-------b]-----------------[]-------------------X------[]----E---EE---
XX---]X--------------------X-XXXXXXXX<>XXXXXXXXXXXXXXXXXXXXXXXXXXXXXXXXXXXXXXXXXXXXXXXXXXXXXXXXXXXXXXXXXXXXXXXXXXXXXXXXXXXXXX---XXXXXXXXXXXXXXXXXXXXXX
