------------------------------------------------------------------------------------------------------------------------------------------------------
------------------------------------------------------------------------------------------------------------------------------------------------------
----------------------------------------------------------------------XXXXXXXXXXXXXXX-----------------------------------------------------------------
----------------------------------------------------------------------XXXXXXXXXXXXXXX-----------------------------------------------------------------
--------------------------------------------------E-------------------XXXXXXXXXXXXXXX-----------------------------------------------------------------
-------------------------------XX---------E-SSSSS-------------------S-XXXXXXXXXXXXXXX-------------------------------SSSS------------------------------
------------------------------XXX------E------------------------------XXXXXXXXXXXXXXX-----------------------------------------------------------------
-----------------------------XXXX-------------------------------------XXXXXXXXXXXXXXX-----------------------------------------------------------------
----------------------------XXXXX----------------------------------S--XXXXXXXXXXXXXXX---------------------------X-------------------------------------
---------------------------XXXXXX------------SSS----------------------XXXXXXXXXXXXXXX------------------S?S-----EX---S-----X---------------------------
---------------------------XXXXXX-------------------------------------XXXXXXXXXXXXXXX-------------------------XXX---------X--------------------B------
---------------------------XXXXXX-----------------------------------E-XXXXXXXXXXXXXXX------------------------XXXX---------XX-------------------b------
E---------------EE---X-----XXXXXX-------------------------------------XXXXXXXXXXXXXXX-----------X-----------XXXXX----EE---XX---E---------------BEE----
XXXXXXXXXXXXXX--XXXXXX-----XXXXXX----------XXXXXXXXXXXXXXXXXXXXXXXXXXXXXXXXXXXXXXXXXX--XXXXXXXXXXXXXXXXXXXXXXXXXXXXXXXXXXXXXXXXXXXXXXXXXXXXXXXXXXXXXXX
