------------------------------------------------------------------------------------------------------------------------------------------------------
-------------------------------------------------------------X----------------------------------------------------------------------------------------
--------------------------------------XXXXXXXXXXXXXXXXXXXXXXXX----------------SSSSSSSSSSSSSSSSSSSSSSSSSSSSSSS-SSSSSSSSSSXSSSSS--------SSSSSSSSSSSSSSSS
--------------------------------------XXXXXXXXXXXXXXXXXXXXXXXX------------------[]----[]------------------------------------------------SSS----SSSSSSS
--------------------E-----------------XXXXXXXXXXXXXXXXXXXXXXXX------------------[]----[]------XE----------------------------------------SSS----SSSSSSS
-XX---------E-SSSSS-----------------S-XXXXXXXXXXXXXXXXXXXXXXXX------------------[]----[]---QQQQQQ------------------------------------SSSSSS----SSSSSSS
XXX------E----------------------------XXXXXXXXXXXXXXXXXXXXXXXX------------------<>----[]------------------SSS-----------------------------------------
XXX-----------------------------------XXXXXXXXXXXXXXXXXXXXXXXX------------------------[]------------------SSSSSS--------------------------------------
XXX--------------------------------S--XXXXXXXXXXXXXXXXXXXXXXXX------------------------[]------------------SSSSSS-------------------------------------?
XXX------------SSS--------------------XXXXXXXXXXXXXXXXXXXXXXXX------------------------[]---SSSSSSSSSSSSS--SSSSSS?SS?SSSS--------------------?S?SSSSSS?
XXX-----------------------------------XXXXXXXXXXXXXXXXXXXXXXXX------------------------<>---SSSSSSSSSSSSS-----------SSSSSSSSSSSS---------------SSSSSS--
XXX---------------------------------E-XXXXXXXXXXXXXXXXXXXXXXXX-----------------------------SSSSSSSSSSSSS-----------SSSSSSSSSSSS---------B-----SSSSSS--
XXX-----------------------------------XXXXXXXXXXXXXXXXXXXXXXXX-----------X-----------------SSSSSSSSSSSSS--------------------------------b-----------oo
XXX----------XXXXXXXXXXXXXXXXXXXXXXXXXXXXXXXXXXXXXXXXXXXXXXXXX--XXXXXXXXXXXXXXXX--XXXXXXE--XXXXXXXXXXXXXXXXXXXXXXXXXX-XXXXEXXXXX--XXXXXXXXXXXXXXXXXXXX
