----------------------------------------------------------------------------------------------------------------------------XXXXXXXXXXXXXXXXXXXXXXXXXY
------------------------------------------------------------------------------------------------------------------------------------------------------
----XXXX----------------------------------------------------------------------------------------------------------------------------------------------
-----[]-----------------------------------------------------------------------------------------------------------------------------------------------
-----[]-----------------------------------------------------------------------------------------------------------------------------------------------
-----[]-----------------------------------------------------------SSSSSSSSS------------------------------?SS------------------------------------------
-----[]-----------------------------------E--E-----------------------------------E---------------------------------------------------------------SSS--
-----[]-------------------------------------------------------------------------<>--------------------------------------------------------------------
-----[]--------------------------------E----------------------------------------[]-----------------------------------------------------------X--------
Q?Q--<>-------X--------------------------------------------------------SSSS-----XX-----------------------------------QQQQ-------------------XX--------
--------------X------------------------------------------B]------------------------------------------E----B--------------------------------XXX--S-----
--------------X---------------------------------------XXXb]------------------------B---<>-----B-----------b-------B--E-------------E------XXXX--------
-------------EX-------------------X------------------XX--B]-----------B----------------[]-----------------------------------------<>-----XXXXX--------
X-EXXXXXXXXXXXX-----XXEXXXXXXXXXXXX--------------XXXXXXXXXXXXXXXXXXXXXXXXXXX---XXXXXXXXXXXXXXXXXXXXXXXXXXXXXXXXXXXXXXXXXXXXXX-----------XXXXXX---EE---
