------------------------------------------------------------------------------------------------------------------------------------------------------
------------------------------------------------------------------------------------------------------------------------------------------------------
------------------------------------------------------------------------------------------------------------------------------------------------------
------------------------------------------------------------------------------------------------------------------------------------------------------
------------------------------------------------------------------------------------------------------------------------------------------------------
-------------------------------------------------------S----------------------------------------------------------------------------------------------
-------------------------------XSSS----------------------------------------------------------------XX-------------------------------ES-------------E--
------------------------------XXX---------------------------------------------------------XSS--o--------------------B--------S--------------------<>--
-----------------S-----------XXXS--------------ooo------------------XSS-SQ---------------XXX------------------------b---------------------QQ------[]--
>------------------------X-XXXXXX----------------------S-----------XXX------------------XXXX-SS--------------------XXX--S----------------------QQQQQQQ
]------------------------X-XXXXXX-SSS-------<>--------------------XXXX-----------------XXXXX----------------------XXXX--------------------------------
]------------------------X-XXXXXX-----------[]-------------------XXXXX----------------XXXXXX--SSS----------------XXXXX---------B----------------------
]---------XXXXXXXXXE-----X-XXXXXX-----------[]------------------XXXXXX--SSSSS--------XXXXXXX--------------------XXXXXX---------b------------B---------
X---------XX-------------X-XXXXXXXX---XXXXXXXXXXXXXXXXXXXXXXXXXXXXXXX-------XX-XXXXXXXXXXXX------XXXXXXXXXX---XXXXXXXXXXXXXXXXXXXXXXXXXXXXXXX--XXXXXEE
