-----------------------------------------------------------XXXXXXXXXXXXX--XX--XXXXXXX---XXXXXXXX--XXXXXXXXXXXX--XXXXXXE--XXXXXXXXXXXXXXXXXXXXXXXXXXXXY
------------------------------------------------------------------------------------------------------------------------------------------------------
SSSSSSSSS-------E---------------------------------SSSSSSSSS-------------------------------------------------------------------------------------------
SSSSSSSSS----------------------------------------SSSSSS----SSSSSSSSSSSSSSSSSSSSSSSSSSSSSSSSSSSS--------------SSSSSSSSSSSSSSSSSSSSSSSSSSSSSSSSSSSSSSSSS
SSSSSSSSS--------------------SSS----XXX----------SSSSSS--------------------------------------------------------[]----[]-------------------------------
SSSSSSSSS-------XQQ?QQX--------------------------SSSSSS--E-------------------------------E---------------------[]----[]-------E-----------------------
-SSSSSSSS-------X-----X---------------------------------<>------------------------------->---------------------[]----[]---QQQQQQ----------------------
-SSSSSSSS-------X-----X------X--------------------------[]------------------------------E----------------------<>----[]------------------SSSSSS-------
oSSSSSSSS-------XE-E--X------XEE------------------------[]--------------------------------------X--------------------[]------------------SSSSSS--SSSS-
>SSSSSSSS-------XQQ-QQX------XSSSSSSSSS-----------------XXS---------------------------------XXXXX--------------------[]------------------SSSSSS--SSSS-
]SSSSSSSS-----------------------------------------------------<>---------------------------XXXXXX--------------------[]---SSSSSSSSSSSSS--SSSSSS--SSSS?
SSSSSSSSS-------------E---------------------------------------[]----E------SS------------XXXXXXXX--------------------<>---SSSSSSSSSSSSS---------------
SSSSSSSSSB----------------------------------------------------[]---<>------SS------------XXXXXXXX-------------------------SSSSSSSSSSSSS--------<>-----
XXXXXXXXXXXXXXXXXXXXXXXXXXXXXXXXXXXXXXXX----XXX---XXXXXXXXXX--[]---[]------SS------------XXXXXXXX-------X-----------------SSSSSSSSSSSSS--------[]-----
