------------------------------------------------------------------------------------------------------------------------------------------------------
------------------------------------------------------------------------------------------------------------------------------------------------------
------------------------------------------------------------------------------------------------------------------------------------------------------
-----------------------------XX-----------------------------------------------------------------------------------------------------------------------
-----------------------------XX-----------------------------------------------------------------------------------------------------------------------
-----E-------------------S---XX---------------------------------------------------------------------------SSSS---------------------QQQQQ--------------
----<>-----------------------XX-----------------------------------------------------------------------------------------------------------------------
----[]-----------------------XX---------------------------------------------------------------------------------------------------------------------o-
----XXX----------------------XX------------------------B----------------------------------------------X----------------------------------------------E
<>----------------<>---SS----XX----------------B-------b-------------------------------------S?S-----EX---S-----X-----------<>----E?SQQS----------SSSS
[]----------------[]---------XX----------------b--?-B------?QQ--------------------------------------XXX---------X-----------[]-----------------E--E---
[]-----<><>-------[]---------XX----------------B----b----------------------------------------------XXXX---------XX----------[]------------------------
[]-----[][]-------[]---------XX--------X----------------------------------------------------------XXXXX----EE---XX---E------[]------------------------
XXXXXXXXXXXXXXXXXXXXXXXXXXXXXXXXXXXXXXXXXXXXXXXXXXXXXXXXXXXXXXXXXXXXXXXXXXX--XXXXXXX--XXX--XXXXXXXXXXXXXXXXXXXXXXXXXXXXXXXXXXXXXXXXXXXXXXXXXXXXXXXXXXX
