------------------------------------------------------------------------------------------------------------------------------------------------------
------------------------------------------------------------------------------------------------------------------------------------------------------
SSSSSSSSSSSSSSSSSSSSSSSSSSSSSSSSS?SSSSSSS--SSSSSSSSSSSSSSSSSSSS---------------------------------------------------------------------------------------
SSSSSS--SSSS------SSSS------------SSSS---------SSSSSSS------------------------------------------------------------------------------------------------
SSSSSS--SSSS--E---SSSS------------SSSS---------SSSSSSS---------------------------E--------------------------------------------------------------------
----SS---S----SS----------oooo----SSSS---------SSSSSSS-------------SSSS-SSSSSSSSSSSSS-------------------------------ES--------------------------------
----SS---S----SS--------------------------------------------------------------------------------------------------------------------------------------
----SS---S----SS----------SSSSS-----------------------------------------------------------------------------------------------------------------------
ooooSS---So??-SS---E------SSSSS-----------------o--------------------------------E------X-------------------------------------------------------------
SSSSSS---SSS--SS--SSSS-------------<>----SSS---S??S---------XXX--X?--------------QQ?QQQQX-------------------------------<>------<>----------B---------
-----------------EE----------------[]--SSSSSS--SSS------------XXXX------------------------------------------------------[]------[]-------QQQo---------
-S---------------------------------[]--SSSSSS--SSS------------XXXX------------------------------------------------------[]------[]--------------------
-------------------------------E---[]----B---------EE---X-----XXXX-----------X-------------------E------------------E---[]---B--[]----------B---------
XXXXXXXXXXXXXXXXXXXXXX---XXXXXXXXX-XXXXXXXXXXXXXXXXXXXXXX-----XXXXXXXX-------XXXXXXXXXXSXXXXXXX---XXXXXXXXXXXXXXXXXXXXXXXXXXXXXXXXXXXXXXXXXXXXXXXXEEXE
