------------------------------------------------------------------------------------------------------------------------------------------------------
------------------------------------------------------------------------------------------------------------------------------------------------------
------------------------------------------------------------------------------------------------------------------------------------------------------
------------------------------------------------------------------------------------------------------------------------------------------------------
------------------------------------------------------------------------------------------------------------------------------------------------------
-------------------------------------------------------E-----oo--------------------XX-----------------------------------------------------------------
---------------------------------------------------------------------XXX-----------XX---------------------ES------E-------E---------------------------
--X-----------------------------------------------XXX----------------------------XXXX--------------S------------QQQ------<>---------------------------
--X------------------------------------------------------------------------------XXXX------------------------------------[]--------<>--------<>-----Q-
--XS-------------------------E--S---------------X--------XXXX--XXXX------------XXXXXX---------------------------------QQQQQQQQQQ---[]--------[]-------
--X----[>------------------E->----------E------XXX-----------------------------XXXXXX--------------------------------------------------------[]-------
--X----[]------------------------------<>-----XXXX-----------------------------XXXXXX----------------B---------------------------------------[]-------
E-Xo?--[]------------------------------------XXXX-----ooo----------------------XXXXXX--------X-------b-------------B-------------------------[]-------
XXXXX---]XXXXXXXXXXXXXXXXXXXXXXXXXXXXXXXXXXXXXXXX-----XXX-------------XXXXXXXXXXXXXXXXXXXXXXXXXXXXXXXXXXXXXXXXXXXXXX--XXXXXEEXXXXXXXXXXXXXXXXXXXXXXXXX
