------------------------------------------------------------------------------------------------------------------------------------------------------
------------------------------------------------------------------------------------------------------------------------------------------------------
SSSSSSSSSSSSSSSSSSSSSSSSSSSSSSSSSSS-----SSSSSSSS--------------SSSSSSSSSSSSSSSSSSSSSSS-----------------------------------------------------------------
-----SSSSSSSSSSSSSSSSSSSS--------[]-------------------X--------------------------[]-------------------------------------------------------------------
-----SSSSSSSSSSSSSSSSSSSS--------[]----------------------------------------------[]-------------------------------------------------------------------
-----SSSSSSSSSSSSSSSSSSSS--------[]----------------------------------------------[]----------------------------------------------------------XX-------
---------------------------------[]-------SSSSSSS-X--------X---------------------[]---------------------------------------------------------XXX-------
---------------------------------[]-------SSSSSS---------------------------------<>--------------------------------------------------------XXXX-------
------------------------>--------[]-------SSSSS----------------------------E----------X---------------------------------------------------XXXXX-------
??S??SSSSSSSSSSSSSSSSSSS]--------[]------?SSS-----------------------------<>-------------------------------------------------------------XXXXXXS------
SSSSS------SS-oo-SSSSSSS]--------<>-----------------------------------S---[]----S-S-S------------E----?QQQ------------------------------XXXXXXX-------
SSSSX------SS----SSSSSSS]-----------------------------X-------ooooooooS---[]----S-S-S--------------------------------------------------XXXXXXXX-------
-------------ooooSSSSSSS]-------------------------------------ooooooooS---[]----S-S-S-------------------------X-----X-----X-----------XXXXXXXXX-------
XXXXXXXXXXXXXXXXXXXXXXXXXXXXEXXXXXXX----XXXXXXXX--------------XXXXXXXXXX--[]----S-S-SXXXXXXXXXXXXXXXXXXXXXXXXXX-----X-----XXXXXXXXXXXXXXXXXXXXXXX-----
