------------------------------------------------------------------------------------------------------------------------------------------------------
------------------------------------------------------------------------------------------------------------------------------------------------------
SSSSSSSSSSSSSSSSSSSSSSSSSSSS-----------------------------------------------XXXXXXXXXXXXXXXXXXXXXXXXXXXX-----------------------------------------------
--------------------------------------------------------------------------XXXXXXXXXXXXXXXXXXXXXXXXXXXXX-----------------------------------------------
------------------------------XXX-----------------------------------------XXXXXXXXXXXXXXXXXXXXXXXXXXXXX-----------------------------------------------
---------------------------------------------XXX----SSS---?-------------S-XXXXXXXXXXXXXXXXXXXXXXXXXXXXX-----------------------------------------------
--------------------------------------------------------------------------XXXXXXXXXXXXXXXXXXXXXXXXXXXXX-------<---------------------------------------
--------------------------------------------------------------------------XXXXXXXXXXXXXXXXXXXXXXXXXXXXX-----------------------------------------------
-----------------------------------SSSSS??--------------------------------XXXXXXXXXXXXXXXXXXXXXXXXXXXXX------------------------Q--?-------------------
>-------------------------XXX------------------------------------------SS-XXXXXXXXXXXXXXXXXXXXXXXXXXXXX---------------------Q-E------ESSS----E--------
]-----------SS-----------EXXX-XXX-----------------------E-----<>----------XXXXXXXXXXXXXXXXXXXXXXXXXXXXX-----------------------E-------------<>--------
]----<>-----SS----------XXX-X---------------------------------[]----------XXXXXXXXXXXXXXXXXXXXXXXXXXXXX---------------------------------------------<>
]--E-[]-----SS---------XXXXXX---------------------------------[]E---------XXXXXXXXXXXXXXXXXXXXXXXXXXXXX------------X--------------------------------[]
XXXXXXXXXX--XX--XXXXXXXXXXXX-------XXXXXXXX--XXXXXXXXXXXXXXXXXXXXXXXXXXXXXXXXXXXXXXXXXXXXXXXXXXXXXXXXXX--XXXXXXXXXXXXXXXXXXXXXXXXXXXXXXXXXXXXXXXXXXXXX
