------------------------------------------------------------------------------------------------------------------------------------------------------
------------------------------------------------------------------------------------------------------------------------------------------------------
------------------------------------------------------------------------------------------------------------------------------------------------------
------------------------------------------------------------------------------------------------------------------------------------------------------
------------------------------------------------------------------------------------------------------------------------------------------------------
-----------------------------------SSSSSSS----------XXXXXXXXXXXXXXX------------------------------------------------------------------------------XXX--
------------------------------------------------------------------------------------------------------------------------------------------------------
------------------------------------------------------------------------------------------------------------------------------------------------------
-------------------------------B----------------------------------------------------------------------------------------------------------------------
------------------------------XXXXESSSSSSS---------------------------------------------------------------------------------------------------QQQQQQQQQ
-E----------------B----------EXXXXX--------------------------------------------------B----------------XX----------------------------------------------
<>----------------b----------XXXXXX--------------------------------------------------b-------------------------------------E--------------------------
[]------X---------BEE-------XXXXXXX-----------B--------------------------E-----------BEE--------------------E------------------------------EE-------X-
XXXXXXX-XXXXXXXXXXXXXXXXXXXXXXXXXXXXXXXXXXXEXXXXXXXXXXXXX--XX--XX--XXXXXXXXXXXXXXXXXXXXXXXXXXXXXXXXXXXXXXXXXXXXXXXXXXXXXXXXXX--XXXXXXXXXXXXXXXXXXXXXQX
