------------------------------------------------------------------------------------------------------------------------------------------------------
------------------------------------------------------------------------------------------------------------------------------------------------------
SSSSSSSSSSSSSSSSSSSSSSSSSSSSSSSS----------------------------------------------------------------------------------------------------------------------
------------------------------------------------------------------------------------------------------------------------------------------------------
----------------------------------XXX----------------------------------------------------------------------------E------------------------------------
-------------------------------------------------XXX----------------XX?XXX-------------------------------E-SSSSS--------------------------------------
------------------------------------------------------------------------------------------------------E-----------------------------------------------
--o----------------------------------------------------------------------------------------------------------------------------------o------XX--------
---E-----------------------------------SSSSS??----------------------------------------------------------------------------------------E-----XX--------
SSSSS-------------------------XXX----------------------------------XXXXX-----------------------S------------SSS--------------------SSSSS----XX--------
--------X-------SSS----------EXXX-XXX-------------------------------------------------------------------------------------------E--E-------XXX-------E
----E---X-------SSS-S-------XXXXX---------------------------------------------XXXXEXXXXX-----------------------------------B-----------E---XXX-------X
o-------X-------SSS--------XXXXXX----------------------------XXXX-------------X--------X---------------------------------------------------XXX------XX
XXXXXXXXXXXXXX--SXX--XXXXXXXXXXX-------XXXXXXXX--XXXXXXXXXX-------------------X--------X------------------XXXXXXXXXXXXXXXXXXXXXXXXXXXXXXXXXXXX---XXXXX
