------------------------------------------------------------------------------------------------------------------------------------------------------
------------------------------------------------------------------------------------------------------------------------------------------------------
------------------------------------------------------------------------------------------------------------------------------------------------------
------------------------------------------------------------------------------------------------------------------------------------------------------
------------------------------------------------------------------------------------------------------------------------------------------------------
-----------------------------------------------------------------------------------------------XX-----------------------------------------------------
--------------------------------------------------------------------------<>-------------------[]---------------------------------------<>------------
--------------------------------------------------------------------------[]-------------------[]---------------------------------------[]------------
E----X-------------------------------------------------------------E------[]-------------------[]--------------------------------E------[]------------
>---XX-----------------------------------ooo-----------------------------S[]-------------------<>SSSSSS--------------------------------S[]------------
----XX---------------------------------------------------------oo---------[]------------X-----------------------------E------oo---------[]------------
SSSSXX---------------------------------------------------------oo---------[]------------XX------E----------------------------oo---------[]------------
------------------------------EE-------------------EE---------------------[]------B-----XXXX------E-------------------------------------[]------B-----
XXXXXXXXXXXXXX--XXXX--XXXXXXXXXXXXXXXXXXXXXX--XXXXXXXXXXXXXXXXXXXXXXXXXXXXXXXXXXXXX-----XXXXXXXXX<>XXXXXXXXXXXXXXXXXXXXXXXXXXXXXXXXXXXXXXXXXXXXXX-----
