------------------------------------------------------------------------------------------------------------------------------------------------------
------------------------------------------------------------------------------------------------------------------------------------------------------
S-SSSSSSSSSSSSSSSSSSSSSSSSSSSSSSSSSSSSSSSSSSSSSSSSSSSSSSSSSSSSSSSSSSSSSSS?SSSSSSSSSSSSSSSSSSSSSSSSSSSSSSSSSSSSSS-------SSSSSSSSSSSSSSSSSSSSSSSSSSSSSSS
--------------------------------------SS--SSSSSS--SSSS------SSSS-------------------------------------------------------SSSSSSSSSSSSSSSSSSSSSSSSSSSSS-S
--------------------------------------SS--SSSSSS--SSSS--E---SSSS-------------------------------------------------------SSSSSSSSSSSSSSSSSSSSSSSSSSSSSSS
-------------------------oooo-------SS--------SS---S----SS----------oooooo---------------------------------------------SSSSSSSSSSSSSSSSSSSSSSSSSSSSSSS
o-------------o---------------------SS--------SS---S----SS--------------------------------------------------------------------------------------------
-----------------------S-SSSS-S-----SS--------SS---S----SS----------SSSSSS----------------------------------------------------------------------------
-------------S---------SoS--SoS-----SS----ooooSS---So??-SS---E------SSSSSS------------------------------------------------------------?---------------
-------XXXX------------SSS--SSS-----SSSS--SSSSSS---SSS--SS--SSSS----------------------------<>--------SSSSS--QQQ----------------XXXXXX??SSSSSSSSSSSSSS
-----XXXXXXXX--XX---------------------SS-------------------EE-------------------------<>----[]--------SSSSS-------------------XXXXXXXX--SSSSSSSSSSSSSS
---XXXXXXXXXX--XXXX-------------------SS----------------------------------------------[]----[]----<>--SSSSS------------------XXXXXXXXX--SSSSSSSSSSSSSS
XXXXXXXXXXXXXE-XXXX-------------------------------------------------------------------[]----[]--E-[]--SSSSS-----------oooooQXQXXXXXXXXooSSSSSSSSSSSSSS
XXXXXXXXXXXXXXXXXXXXXXXXXXXXXXXXXXXXXXXXXXXXXXXXXXXXXXXXXXXXXXXX---XXXXXXXXXXXXXXXXXXXXXXXXXXXXXXXXXX-XXXXXXXXXX------XXXXXXXXXXXXXXXXXXXXXXXXXXXXXXXX
