------------------------------------------------------------------------------------------------------------------------------------------------------
------------------------------------------------------------------------------------------------------------------------------------------------------
------------------------------------------------------------------------------------------------------------------------------------------------------
------------------------------------------------------------------------------------------------------------------------------------------------------
------------------------------------------------------------------------------------------------------------------------------------------------------
----?SS----------------------------------------------SSSSSSS---------------E--------------------------------------------------------------------------
------------------------------------------------------------------------E----------------E------------------------------------------------------------
--E----------------------------------------------------------------------------X---------------------------------------------------------oooo---------
-<>--------------------------B------------------------E--E-----------XSSSSSSSSS?--------------------------E------------------------------oooo---------
-[]------------------B-------b-----------------------SSSSSSS--------XX------------XXXX--------------XXX--<>------------S-----XX--X--------------------
-[]------------------b--?-B------?QQ---------oooQ------------------XXX----oooooooo-----------E-----------[]-----------------XXX--X--------------------
-[]------------------B----b---------------------------------------XXXX-----------------------------------[]----------SS-SS-XXXX--X----XXXXXXXXXXXXXXX-
X[]---------X----------------------------------------------------XXXXX----oooooooo-----------------------[]--------X-SS-SSXXXXX--X----X-------------X-
XXXXX-----XXXXXXXXXXXXXXXXXXXXXXXXXXXXXXXXXXXXXXXXXXXXXXX--XXXXXXXXXXXXXXXXXXXXXXX-----------XXXXXXX-----[]---XXXXXXXXXXX-XXXXX--X----X-------------X-
