------------------------------------------------------------------------------------------------------------------------------------------------------
------------------------------------------------------------------------------------------------------------------------------------------------------
------------------------------------------------------------------------------------------------------------------------------------------------------
------------------------------------------------------------------------------------------------------------------------------------------------------
------------------------------------------------------------------------------------------------------------------------------------------------------
---------------------------------------------------------------------------------------------E----------------------?----------------SSS------?SS-----
--------------------------------------------------------------------------------------------X---------------------------------------------------------
--------------------------------------------------------------------------------------------X---------------------------------------------------------
---------------------------------------------------------------------------------------X----XE----X---------SSS---------------------------------------
?QQQQQQ?-------------------------?QQQQQQ-Q?----------------------XS--------------------X---]XQQ?QQX---------------------------------------------------
------------------------------------------------------------XXXXXX---------------------X----------------B--------E-------------------------E---B------
B------------------------?--------------------------?---------------------------------SX----------------b--------------------------------------b------
b-E----B--------E----------------B-E------B-----E-------E--------E----------------------------------------------------B--------X----------------------
XXXXXXXXXXX---XXXXXXEXEXX-XXXXXXXXXXXXXX-XXXXXXXXXXX-XXXXXXXXXXXXXXXXXXXXXXXXXXXXXXXXXXXXXXXXXXXXXXXXXXXXXXXXXXXXXXXXXX--X---XXXXXXXXXXXXXXXXXXXXXXXXX
