------------------------------------------------------------------------------------------------------------------------------------------------------
------------------------------------------------------------------------------------------------------------------------------------------------------
------------------------------------------------------------------------------------------------------------------------------------------------------
------------------------------------------------------------------------------------------------------------------------------------------------------
-----------------------------------------------------oo--oo-------------------------------------------------------------------------------------------
---------------------------------------------oo---------------------------E-----oo--------------------XX------------------------------------SS--------
----------------------------------E---XXXX----------------------------------------------XXX-----------XX----------------------------------------------
---------------------oooo---------------------------------------XXXXXXXX----------------------------XXXX--------------------------------------------o-
---------------------oooo---------------------XXX---------------------------------------------------XXXX----------------------------------------------
---S-----XX--X------------------E---------------------XXX-------------------XXXX--XXXX------------XXXXXX----------------QQ-----------------XXXX--SSS--
-SS-SS--XXX--X----------------------XXX-----------------------------------------------------------XXXXXX--------------------------------XXXXX---------
-SS-SS-XXXX--X----XXXXXXXXXXXXXXXX------------------------XXXX------------------------------------XXXXXX-----------------------------XXXXXX-----------
-SS-SSXXXXX--X----X--------------X---------------------------------------ooo----------------------XXXXXX--------X-----------------XXXXXXX-------------
XXXXX-XXXXX--X----X--------------X---------------------------------------XXX-------------XXXXXXXXXXXXXXXXXXXXXXXXXXXXXXXXXXX--XXXXXXXXX------XXS-XXXXX
