------------------------------------------------------------------------------------------------------------------------------------------------------
------------------------------------------------------------------------------------------------------------------------------------------------------
------------------------------------------------------------------------------------------------------------------------------------------------------
------------------------------------------------------------------------------------------------------------------------------------------------------
------------------------------------------------------------------------------------------------------------------------------------------------------
------------S--------XQQ?QQX-----------------------------------------------------XX------------------------------------------------QQQ?QQQ?QQQQQ------
------------S--------X-----X----------------------------------------------------XXX-------------------------------------------------------------------
---------------------X-----X---------------------------------------------------XXXX-------------------------------------------------------------------
------------SSS------XE-E--X------------------B-------------------------------XXXXX---------------E--------------oo-----------------------------------
------------SSS------XQQ-QQX------------------------------SSQS--------X------XXXXXX--S--------------------------o--o---------------Q-SSSSSSSSSSS------
------------SSS-------------------[]----------XXXXX<>--XX---------E---X-----XXXXXXX------------------<>-----------------------------------------------
-------------SS------------E------[]---------XXXXX-[]-----------------X----XXXXXXXX------------------[]-----------------------------E---E---E---------
-E---------X-SS-------------------[]--------XXXXXX-[]---------------------XXXXXXXXX-------X----------[]-----------------------------------------------
XXXXXXX----XXXXXXXXXXXXXXXXXXXXXXXXXXXXXXXXXXXXXXXSXXXXXXXXXXXXXXXXXXXXXXXXXXXXXXXXXXXXXXXXXXXXXXXXXXXXXXXXXXXXXXXXXXXXXXXXXXXXXXXXXXXXXXXXXXX--XXXXXX
