------------------------------------------------------------------------------------------------------------------------------------------------------
------------------------------------------------------------------------------------------------------------------------------------------------------
E-----------------------------------------------------------------------------------------------------------------------------------------------------
>-----------------------------------------------------------------------------------------------------------------------------------------------------
]-----------------------------------------------------------------------------------------------------------------------------------------------------
]S----------------------XS-----------------------------------------------------------------------------------E-----oo--------------------XX-----------
X----------------------EX--------------------------------------------------------------------------------------------------XXX-----------XX-----------
----------------------XXX------------------------------------------------------------------------------XXXX----------------------------XXXX-----------
---------------------XXXXS---------------------------B-------------------------------SSSSS---------------------------------------------XXXX-----------
-----------<>-------XXXXX------------------B---------b----------------------------------------------<>---------XXXX--XXXX------------XXXXXX-----------
-----------[]------XXXXXX------------------b--?-B-o------?QQ----------------------------------------[]-------------------------------XXXXXX-----------
-----------[]-----XXXXXXX------------------B----b---------------------------------------------------[]-------------------------------XXXXXX-----------
-----------[]----XXXXXXXX---------X-----------------------------------------------------------------[]-------oo----------------------XXXXXX--------X--
XXXXXXXXXXXXXXX-XXXXXXXXXXXXXXXXX-XXXXXXXXXXXXXXXXXXXXXXXXXXXXXXXXXXXXXXXX--XXXXX--X-XXXXX---XXXXXXXXXXXXXXSSXX-------------XXXXXXXXXXXXXXXXXXXXXXXXXX
