--------------------------------------------------------------------------------------------------E---------------------------------------------------
------------------------------------------------------------------------------------------------------------------------------------------------------
-----------------------------------------------------------------------XXXXXXXXXXXXXXXXXXXXXXXXXXXX---------------------------------------------------
-----------------------------------------------------------------------XXXXXXXXXXXXXXXXXXXXXXXXXXXX---------------------------------------------------
----------------------------------------------------E-----------------oXXXXXXXXXXXXXXXXXXXXXXXXXXXX----------------ooo--------------------------------
---------------------------------XX---------E-SSSSS------------------S-XXXXXXXXXXXXXXXXXXXXXXXXXXXX----------------XXXX-----------------------------XX
--------------------------------XXX------E-----------------------------XXXXXXXXXXXXXXXXXXXXXXXXXXXX------oo-----------------------------------------XX
-------------------------------XXXX------------------------------------XXXXXXXXXXXXXXXXXXXXXXXXXXXX------------------------------XX-----------------XX
------------------------------XXXXX---------------------------------S--XXXXXXXXXXXXXXXXXXXXXXXXXXXX------------------------------XX--------------X--XX
-----------------------------XXXXXX------------SSS---------------------XXXXXXXXXXXXXXXXXXXXXXXXXXXX-------------------SSSS-------XX-------------XX--XX
-----------------------------XXXXXX------------------------------------XXXXXXXXXXXXXXXXXXXXXXXXXXXX-----------XXX-?-------------XXX----------EXXXX--XX
-----------------------------XXXXXX----------------------------------E-XXXXXXXXXXXXXXXXXXXXXXXXXXXX-----------------------------XXX----------XXXXX----
E-----------------EE---X-----XXXXXX------------------------------------XXXXXXXXXXXXXXXXXXXXXXXXXXXX-----------------------------XXX---------XXXXXX----
XXXXXXXXXXXXXXXX--XXXXXX-----XXXXXX----------XXXXXXXXXXXXXXXXXXXXXXXXXXXXXXXXXXXXXXXXXXXXXXXXXXXXXX------XXXX-----XXXXX-XXXXXXXXXXX--XXEXXXXXXXXXXXXXX
