------------------------------------------------------------------------------------------------------------------------------------------------------
------------------------------------------------------------------------------------------------------------------------------------------------------
------------------------------E-----------------------------------------------------------------------------------------------------------------------
------------------------------------------------------------------------------------o-----------------------------------------------------------------
------------------------------------------------------XX----------------------------------------------------------------------------------------------
---------?SS------------------------------------------------------------------------------------------------------------------------XX----------------
----------------------------------------------------E----------o----ooo-------------------------------------------------------------------------------
-----------------------XX-----------------------XXXXXX-------------------XX------------------E------------------------------------------E-------------
----------------------XXX--------------------------------XXX-------------------------------------------------------------------<>---------XXXX--------
---------------------XXXX--------------------------------------------XXXX--SS-----------------------------------QQQQQQQ------?-[]---------------------
------E---B----------XXXX-------------------XXXXX-------------------------------------------------------------------------<>---[]------------------XXX
B---------b--------B-XXXX-----------------------------------------------XXXXXX--------------------------------------------[]---[]---------------------
---------------------XXXX-----XX------------------------------XXXXXXX---------------------------X-------------EE------X---[]---[]---------------------
XXXXXXXXXXXXXXXXXXXXXXXX--XXXXXXXXXXXXXXXX--------------XXX------------------------------XXXXXXXXXXXXXXXXXXXXXXXXXXXXXX---XXXXXXX-XXXX----------------
