------------------------------------------------------------------------------------------------------------------------------------------------------
------------------------------------------------------------------------------------------------------------------------------------------------------
------------------------------------------------------------------------------------------------------------------------------------------------------
-----------------------------------------------------------?------------------------------------------------------------------------------------------
------------------------------------------------------------------------------------------------------------------------------------------------------
------------------------------------------------------------------------------------------------------------------------------------XXX-----XXXXXXE---
--------------------------------------E-----------XX-------XX--------------------E-------------E-------------------------------XXX--------------------
X-------oooo--E--------------------------XX-----------------------------------------------------------------------------------------------------------
X-------oooo-----------E------------------------------------------------------------------------------------------------------------------------------
X---------------------<>--------XXX-------o-------------------------------------------------------------------Q-----------XXX-------------------------
X---------------------[]------------------o--XX------------------------------------XX------------XX---------------------------------------------------
X----XXXXXXXXXXXX-----[]------------------------------------------------------------------------------------------------------------------------------
>----X----------------[]-----------------------------------------XXXEXXEX----XXX---------BXXXX-----------------E-----------------------------------XXX
X----X----------------[]---XXXXXXXX---------------------------------------------------------------------XXXXXX<>--------------------------------------
