------------------------------------------------------------------------------------------------------------------------------------------------------
------------------------------------------------------------------------------------------------------------------------------------------------------
------------------------------------------------------------------------------------SSS---------------------------------------------------------------
------------------------------------------------------------------------------------[]----------------------------------------------------------------
------------------------------------------------------------------------------------[]----------------------------------------------------------------
------------------------------------------------------------S-------SSS-------------[]---------------------XX--------XXX--------XX--------------------
------------------------------------------------------------------------------------[]--------------------XXX--------XXX--------XX--------------------
------------------------------------------------------------------------------------[]-------------------XXXX--------XXX--------XX--------------------
------------------------------ooo--------------------------E-EE---------------------[]-------E----------XXXXX--------XXX--------XX--------------------
------------------------------ooo---------------------X--------XX-XX----------------[]------<>---------XXXXXXS-------XXX--------XX--------------------
-----X----------------------------------------E------XXX-------XX-XX----------------<>----------------XXXXXXX--------XXX--------XX--------------------
E----X---------------------------------------<>-----XXXX-------XX-XXX--------------------------------XXXXXXXX--------XXX--------XX---------------B----
-----X--------------EE-----------------------------XXXX--------X--XXX--E----------------------------XXXXXXXXX--------XXX--------XX---------------b----
XX---XXXXXXXXXXXXXXXXXXXXXXXXXXXXXXEEXEXXXXXXXXXXXXXXXX--------X--XXXXXXXXXXXXXXXXXXXXXXXXEXXXXXXXXXXXXXXXXXXXX------XXX--------XXXXXXXXX---XXXXXXXXXX
