------------------------------------------------------------------------------------------------------------------------------------------------------
------------------------------------------------------------------------------------------------------------------------------------------------------
--------------------------------------------------------------SSSSS---------------------------SSSSSSSSSSSSSSSS-------------SSS--[]SSSSSSSSSSSSS-------
---------------------------------------------------------o----[-------------------------------SSSS------------------------------[]SSSSSSSSSSSSS-------
--------------------------------------------------------------[-------------------------------SSSS------------------------------[]SSSSSXSSSSSSS-------
---------E---------------------------------------------SSS----[--E----------------------------SSSS------------------------------[]SSSSSSSSSSSSS-------
--------<>------------------------------------------------------<>--------------------------------------------------------------[]SSSSSSSSSSSSS-------
--------[]------------------------------------------------------[]-----------------------------------------------XXX------------[]SSSSSSSSSSSSS-------
Q?------[]------------------------------------------------------XXX---------------------<>-----o---------------------------------]SSSSSSSSSSSSS-------
--------XXX----------S------<>------------SSS------<>---S---<>----------------<>---SS---[]----S?SS---------XXX------------------o]SSSSSSSSSSSSS------E
--------------X-------------[]---S-----------------[]-------[]----------------[]--------[]----SSS-------------------SSS-S--SSSSSSSSSSSSSSSSSSSS-----<>
--------------X-------------[]---------------------[]-------[]-----<><>-------[]--------[]----SS--------------------SSS-S--SSSSSSSSSSSSSSSSSSSS-----[]
--------------X-------------[]------XX-------------[]----E--[]-----[][]-------[]--------[]------E-EE---X------------SSS-S--SSSSSSSSSSSSSSSSSSSS-----[]
XX--XXXXXXXXXXXXXXXXXXXXXXXXXXXXXXXXXXXXXXXXXXXXXXXXXXXXXXXXXXXXXXXXXXXXXXXXXXXXXXXXXXXXXXXXXXXX-XXXXXXX---------XXXSSS-S--XXXXXXXXXXXXXXXXXXXX-----XX
