------------------------------------------------------------------------------------------------------------------------------------------------------
------------------------------------------------------------------------------------------------------------------------------------------------------
--------------XXXX------------------------------------------------------------------------------------------------------------------------------------
---------------[]-------------------------------------------------------------------------------------------------------------------------------------
---------------[]-----------------------------------------------------E--XXX----XXX------E------------------------------------------------------------
---------------<>--------<>---------------------------------------------------------------------------------E-----SSS---------------------------------
oo----------------------X[]----------------------------------------------------------------------S-----------------------------E----------------------
--------X-------E------XX[]------------------------------oooo---------X-------------------------------------------------------<>----------------------
-----------------------XX[]------------------------------oooo----------------------------------------------------------?------[]----------------------
---------------------<>XX[]------------S-----XX--X-------------XXX-----------------------------------------<>------XXX--------XX----------------------
--------------------X[]XX[]-----------------XXX--X---------------------------------------------------------[]--------------------------------------E--
-----------------<>XX[]XX[]----------SS-SS-XXXX--X----XXXXXXXX-----------------------------X---------------[]--------------------B---<>-----B---------
-----------------[]XX[]XX[]--------X-SS-SSXXXXX--X----X------------------------------------X---------------[]------------------------[]---------------
XXXX----XXXXX----[]XXXXXXXXXXXXXXXXXXXXXX-XXXXX--X----X------------------------------------XXXXXXXXXXXXXXXXXXXXXXXXXXXXXX--XXXXXXXXXXXXXXXXXXXXXXXXXXX
