------------------------------------------------------------------------------------------------------------------------------------------------------
------------------------------------------------------------------------------------------------------------------------------------------------------
----------------S-------------------------------------------------------------------------------------------------------------------------------------
--XXXXXXXXXXXX--S-------------------------------------------------------------------------------------------------------------------------------------
-XX-------------S-------------------------------------------------------------------------------------------------------------------------------------
XXX-------------S------------------XXX-----XXXXXE-----------------------------------XXXXXX--------------------------------SSSS----------------E-------
XXX-------------S------------XXX----------------------------------------E--------------------------------------------------------------------<>-------
XXX-------------S----------------------------------------------------------------------------------------------------------------------------[]-------
XXX-------------S------------------------------------------------------------------------XXXXXXX----------------------X----------------------[]-------
XXX-------------S-------XXX--------XXX----------------------------------------XXX----------------------------S?S-----EX---S-----X------------XXXX----<
XXX-----<>------S---------------------------------------------------------XX----------------------------------------XXX---------X--------------------[
XXX-----[]------S--------------------------------------------------------------------------------------------------XXXX---------XX-------------------[
XXX-----[]------S--------------------------------XXXXEXXEX----XXX---XXX-------------------------------X-----------XXXXX----EE---XX---E---------------[
XXXXXXXXXXXXXXXXX-XX-----------------------------------------------------------------------------XXXXXXXXXXXXXXXXXXXXXXXXXXXXXXXXXXXXXXXXXXXXXXXXXXXXX
