------------------------------------------------------------------------------------------------------------------------------------------------------
------------------------------------------------------------------------------------------------------------------------------------------------------
S-----------------------------------------------------------------------------------------------------------------------------------------------------
------------------------------------------------------------------------------------------------------------------------------------------------------
------------------------------------------------------------------------------------------------------------------------------------------------------
---------------XXX--------XXXXX--------XXX------------XX--XXXX-------------------------------------------------XX----------XX-------------------------
]------XX-----------------------------------------XX----------------------------------------------------------XXX----------XX-------------------------
]---------------------oo-------------------------------------------------------------------------------------XXXX----------XX-------------------------
]---------------------SS------------------------------------------------------------E-----------------------XXXXX----------XX------------------------X
]--------------------------------------------XX------------------------------------------------------------XXXXXX----------XX---------------S?S-----EX
]----------------------------------------------------------------------------------<>----------X----------XXXXXXX-]--------XX----------------------XXX
]------------------------------------------------------------------------------Q---[]--------------------XXXXXXXXB]--------XX---------------------XXXX
]-------------o---o---------------------------------------------------X------------[]-------------------XXXXXXXXXb]--------XX--------X-----------XXXXX
X-------------X---X---------------XXX---------------------XXXXXXX-----XXXXXXXXXXXXXXXXXXXXXXXXXXXXXXXXXXXXXXXXXXXXXXXX-----XXXXXXXXXXXXXXXXXXXXXXXXXXX
