------------------------------------------------------------------------------------------------------------------------------------------------------
------------------------------------------------------------------------------------------------------------------------------------------------------
SSS---SSSSSSSSSSSSSSSSSSSSSSSSSSSSSSSSSSSSSSSSSSSS-------------SSS-[]SSSSSSSSSSSSSS-------------------------------------------------------------------
---------------------------SSSSSSSSSS------------------------------[]SSSSSSSSSSSSSS-------------------------------------------------------------------
---------------------------SSSSSSSSSS------------------------------[]SSSSSSSSSSSSSS------------------------------------------E-E----------------------
---------------------------SSSSSSSSSS------------------------------[]SSSSSSSSSSSSSS-------------E----------QQQ?QQQ---------SSSSSSS-SS----------------X
-----SSSSSSS-------------------------------------------------------[]SSSSSSSSSSSSSS------------<>---------------------------------E---------------E--X
-----SSSSSSS--SSSSS----------------------------------XXX-----------[]SSSSSSSSSSSSSS------------[]------------E------------------------------------XX-X
-----SSSSSSS--SSSSS-------------------------------------------------]SSSSSSSSSSSSSS-------------]----------SSSSSSS--------------------------------XX-X
SSS--SSSSSSS--SSSSS?SS?????SSSSSSSSSS----------XXX----------S---S---]SSSSSSSSSSSSSS----E--------]---<>--------------E--------------<>-------<>----XX-X
SSS-------------------SSSSS-----------------------------SSS-S--SSSSSSSSSSSSSSSSSSSS---->-------->---[]-------X------X-------E------[]-------[]----XX-X
SSS---------<>--------SSSSS-----------------------------SSS-S--SSSSSSSSSSSSSSSSSSSS----]------------[]-------X------X--------------[]-------[]----XX-X
SSS---------[]-----------------------------X------------SSS-S--SSSSSSSSSSSSSSSSSSSS----]------------[]----E--X------X--------------[]-------[]----XX-X
XXXXXXXXXXXXXXXXXXXXXXXXXXXXXXXXXXXXXXXEXXXX---------XXXSSS-S--XXXXXXXXXXXXXXXXXXXXXX--]XXXXXXXXXXXXXXXXXXXXXXXXXXXXXXXXXXXXXXXXXXXXX-------XX-XXXXX-X
