------------------------------------------------------------------------------------------------------------------------------------------------------
------------------------------------------------------------------------------------------------------------------------------------------------------
------------------------------------------------------------------------------------------------------------------------------------------------------
------------------------------------------------------------------------------------------------------------------------------------------------------
------------------------------------------------------------------------------------------------------------------------------------------------------
------------------------------------------------------------------------------------------------------XX----------------------------SSSS--------------
-----------------------------------------------------------------------------------------------------XXX----------------------------------------------
----------------------------------------------------------------------------------------------------XXXX----------------------------------------------
-------------------------------E-------------------------------------------------------------------XXXXX------------------------X---------------------
----------------------ooo-----<>-------------------------------ooo--------------------------------XXXXXX---------------S?S-----EX---S-----X-----------
-------------------------------------------------------------------------------------------------XXXXXXX----------------------XXX---------X-----------
------------------------------------------------------------------------------------------------XXXXXXXX---------------------XXXX---------XX----------
-----------EE----------------------------------------EE-------------------EE-------------------XXXXXXXXX--------X-----------XXXXX----EE---XX---E------
X-XXXXXXXXXXXXXXXXXXXXXXX--XXXXXXXXXX---XXXXXXXXXXXXXXXXXXXXXXXXXX--XXXXXXXXXXXXXXXXXXXXXXXXXXXXXXXXXXXX-----XXXXXXXXXXXXXXXXXXXXXXXXXXXXXXXXXXXXXXXXX
