------------------------------------------------------------------------------------------------------------------------------------------------------
------------------------------------------------------------------------------------------------------------------------------------------------------
---------------------------------------------------------------------------------------------------------------?--------------------------------------
------------------------------------------------------------------------------------------------------------------------------------------------------
-----------------------------------------------E------------------------------------------------------------------------------------------------------
-------------------------------------------SSSSSS----S----------------------------------------SSSSS------------------------------XESSSS---------------
-----------------------------------------------------------------------------------------------------------------SS-------------XXX-------------------
------------------------B---------------------------------------------------------------------------------------------X--------XXXX-------------------
------------------------b-------------------E--------------------------------------------------E-------------SS------XX-------XXXXX-------------------
QQQ-------------------SSXSS---------------SSSSSSS---------------------------------------------SSSSS-----------------XXX------XXXXXX---S---E-----------
------B-----E---B-------------------<>---------------<>--------------<>------------------------------X----B--------XXXX-----XXXXXXX------<>-----------
E-----b---------b-----------B-------[]---------------[]---------B----[]----<>-----B-----<>-----------X----b-------XXXXX----XXXXXXXX------[]-----------
------------------------------------[]---------------[]--------------[]-E--[]-----------[]-----------X-----------XXXXXX---XXXXXXXXX------[]-E---------
XXXXXXXXXXXXXXXXXXXXXXXXXXXXXXXXX--XXXXXXXXXXXXXXXXXXXXXXXXXXXXXXXXXXXXXXXXXXXXXXXXXXXXXXXXXXXXXXXXXXXXXXXXXXXXX-XXXXXXXXXXXXXXXXXXXXXXXXXXXXXXXXXXXXX
