------------------------------------------------------------------------------------------------------------------------------------------------------
------------------------------------------------------------------------------------------------------------------------------------------------------
------------------------------------------------------------------------------------------------------------------------------------------------------
------------------------------------------------------------------------------------------------------------------------------------------------------
------------------------------------------------------------------------------------------------------------------------------------------------------
SSSX----------------------------------------------------------------------XXX---------------------------------------------------------------------SSSS
-----------X--EX-----------------------------------------------E---------XEXX-------------------------------------------------------------------------
-----------X---X--------------------------------------------------------EXXXX-------------------------------------------------------------------------
-----X---X-X---X--------X-EE----X-------------ooo----------------------EXXXXX---------------E----------------------------XSSS----------------------E--
-----X-SSX-XSS?X--------XSSSSSSSX-------------------------------------XXXXXXX--------------------------------------------X----------------------------
-------------------------------------------------------E-------------XXXXXXXX------------------<>------------------------X----------------------------
--------------------------------------------------------------------XXXXXXXXX------------------[]------------------------X--------X--------B----------
-------------------------------------------------------------------XXXXXXXXXX-------X----------[]---------------------E-EX--------X--------b----------
X--XXXXXXXXXXXXXXXXXX--XXXXXXXXXXXXEEXEXXXXXXXXXXXXXXXXXXXXXXXXXXXXXXXXXXXXXXXXXXXXXXXXXXXXXXXXXXXXXXXXXXXXXXXXXXXXXXXXXXXXXXXX---XXXXXXXXXXXXXXXXXXXX
