------------------------------------------------------------------------------------------------------------------------------------------------------
------------------------------------------------------------------------------------------------------------------------------------------------------
---------------------------XXXX--------------SSSSSSSSSSSSSSSSSSSSSSSSSSSSSSSSSSSSS--------------------------------------------------------------SSSSSS
---------------------------XXX-----------------[]---[]------------------------------------------XX----------------------------------------------[]----
---------------------------XXX-----------------[]---[]-------E----------------------------------XX----------------------------------------------[]----
-------------------------S-XXX-----------------[]---[]---QQQQQQ-----------------E-----------S---XX-----------------------------XX---------------[>----
---------------------------XXX-----------------<>---[]-------------------------<>---------------XX----------------------------XXX---------------------
---------------------------XXX----------------------[]-------------------------[]---------------XX----------------------------XXX---------------------
------------------------S--XXX----------------------[]-------------------------[]---------------XX----------------------------XXX---------------------
---<>----------------------XXX----------------------<]---SSSSSSSSSSS-----------XXX----<>---SS---XX----------------------------XXX------------S?S------
---[]----------------------XXX----------------------->---SSSSSSSSSSS-SS---------------[]--------XX-------<>-------------------XXX---------------------
---[]--------------------E-XXX---------------------------SSSSSSSSSSSSSS---------------[]--------XX-------[]-------------------XXX---------------------
E--[]----------------------XXX----------X----------------SSSSSSSSSSSSSS---------------[]--------XX-------[]-E-----------------XXX-------X-------------
XXXXXXXXXXXXX--XXXXXXXXXXXXXXXXXXXXXXXXXXXXXXXX--XXXXXE--XXXXXXXXXXXXXXXXXXXXXXXXXXXXXXXXXXXXXXXXXXXXXXXXXXXXXXXXXXXXXXXXXXXXXXXXXXXXXXXXXXXXXXXXXX---
