------------------------------------------------------------------------------------------------------------------------------------------------------
------------------------------------------------------------------------------------------------------------------------------------------------------
------------------------------------------------------------------------------------------------------?-----------------------------------------------
------------------------------------------------------------------------------------------------------------------------------------------------------
--------------------------------------E---------------------------------------------------------------------------------------------------------------
----S-----------------------------SSSSSS----S----------------------------------------SSSSS------------------------------XS----------------------------
--------------------------------------------------------------------------------------------------------SS-------------EX-----------------------------
E--------------B---------------------------------------------------------------------------------------------X--------XXX-----------------------------
>--------------b-------------------E--------------------------------------------------E-------------SS------XX-------XXXXS-------------------------B--
]------------SSXSS---------------SSSSSSS---------------------------------------------SSSSS-----------------XXX------XXXXX------------------B-------b--
---------------------------<>---------------<>--------------<>------------------------------X----B--------XXXX-----XXXXXX------------------b--?-B-----
-------------------B-------[]---------------[]---------B----[]----<>-----B-----<>-----------X----b-------XXXXX----XXXXXXX------------------B----b-----
---B-----------------------[]---------------[]--------------[]-E--[]-----------[]-----------X-----------XXXXXX---XXXXXXXX---------X-------------------
XXXX-XX--BXXXXXXXXXXXXXX--XXXXXXXXXXXXXXXXXXXXXXXXXXXXXXXXXXXXXXXXXXXXXXXXXXXXXXXXXXXXXXXXXXXXXXXXXXXXX-XXXXXXXXXXXXXXXXXXXXXXXXX-XXXXXXXXXXXXXXXXXXXX
