------------------------------------------------------------------------------------------------------------------------------------------------------
------------------------------------------------------------------------------------------------------------------------------------------------------
---------------------------------------------------------------E--------------------------------------------------------------------------------------
----------------------------------------------------------------------------------------------------------------------?-------------------------------
--------------E---------------------------------------------------------------------------------------------------------------------------------------
-------------SQS--SQS--------------------------------XXX-------------------------------------------------------------------------XX--XXXXX------------
----------------------------------------------------XXXX-----------------------------------------E-----------XX-------XX-----XX-----------------------
----XX-------------------------o------XX-----------EXXXX--------------------------------------------XX------------------------------------------------
---XXX--------------------------E-----XX----------XXXXXX----------------------------------------------------------------------------------------------
--XXXX-------SQS--S?S--------SSSSS----XX---------XXXXXXX-------------SSS-------XXX-------XXXXX-------o------------------------------------------------
XXXXXX--------------------E--E-------XXX-------EXXXXXXXX---------------------------------------------o--XX--------------------------------------------
XXXXXX---------------------------E---XXX-------XXXXXXXXX----------------------------------------------------------------------------------------------
XXXXXX-----E-------------------------XXX------XXXXXXXXXX-------XX---------------------------------------------------------------------------------X---
XXXXX--XXXXXXXXXXXXXXXXXXXXXXXXXXXXXXXXX---XXXXXXXXXXXXXXXXXXXXXXXXXXXXXXXX----------------------------------------------------------XXXXXXXX-----XXXX
