------------------------------------------------------------------------------------------------------------------------------------------------------
------------------------------------------------------------------------------------------------------------------------------------------------------
------------------------------------------------------------------------------------------------------------------------------------------------------
------------------------------------------------------------------------------------------------------------------------------------------------------
------------------------------------------------------------------------------------------------------------------------------------------------------
-S------XXX-----XXXXXXE-----------------------------XXXXXXX------------------XXXXXXXXX--------------SSS------XQQ?QQX-------------Q?QQX----------------
----------------------------------------E------------------------XXX-----------------------------------------X-----X-----------------X----------------
-------------------------------------------------------------------------------------------------------------X-----X-----------------X-----X----------
S----------------------------------------------------------------o-o-----------------------------------------XE-E--X-----------XE-E--X-----X---------X
----------------------------------------------XXX----------------o-o-XXX-------------------------------------XQQ-QQX-----------XQQ-QQX-----X---------X
oooo--------------------------------------XX--------------------------------------------------------B-------------------------------------E-----------
----------------------------------------------------------------------------------------------------b--------------E-----------------E----------------
ooooooo----------------XXXXEXEXX----XXX--------------------------------------------------E----------BEE-----------------------------------------------
XXXXXXX----X-------------------------------------------------------------XXEXXXEX-XX--XXXXXXXXXXXXXXXXXXXXXXXXXXXXXXXXXXXXXX--XXXXXXXXXXXXXXXXXXXX--XX
