------------------------------------------------------------------------------------------------------------------------------------------------------
------------------------------------------------------------------------------------------------------------------------------------------------------
------------------------------------------E-----------------------------------------------------------------------------------------------------------
------------------------------------------------------------------------------------------------------------------------------------------------------
---------------------------------------------------------------------------E--------------------------------------------------------------------------
----------------------------------SSSSSSSS?S--------S----S---------------------------------SSSSSSS----------XXXXXXXXXXXXXXXX--------------------------
-----ES--------------E-------------[]-------------------------------S--------<>-----------------------------------------------------------------------
------------QQ------<>-------------[]----------------------------------------[]-----------------------------------------------------------------------
--------------------[]-------------[]----------------------------------------[]--------B--------------------------------------------------------------
-----------------QQQQQQQQQQ--------[]---------------<>-----------------X-----XX-------XXXXESSSSSSS----------------------------------------------------
-----------------------------------<>---------------[]---------E---------------------XXXXXX--------------------------------------------QQQQQoX?-------
B---------------------------------------------------[]--------<>--------------------XXXXXXX-----------------------------------------------------------
b-------------B---------------------E---------------[]--------[]-----X-------------XXXXXXXX-----------B---------------------------E-----------------X-
XXXXXXXXXXXXXXX--XXXXXEEXXXXXXXXXXXXXXXXXXXXXXXXXXXXXXXXXXXXXXXXXXXXXX-------------XXXXXXXXXXXXXXXXEXXXXXXXXXXXXXX--XX--XX--XXXXXXXXXXXXXXXXXXXXXXXXX-
