------------------------------------------------------------------------------------------------------------------------------------------------------
------------------------------------------------------------------------------------------------------------------------------------------------------
------------------------------------------------------------------------------------------------------------------------------------------------------
-------------------------------------------------------------------------------XX---------------------------------------------------------------------
-------------------------------------------------------------------------------XX---------------------------------------------------------------------
---------------------------E-------------------------SSSSS---?-------------S---XX---------------------------------------------------------------------
-------------------------------------------------------------------------------XX---------------------------------------------------------------------
-o------XX---------------------------------------------------------------------XX---------------------------------------------------------------------
--E-----XX---------------------------------------------------------------------XX----------------------?----------------E-----------------------------
SSSS----XX----------------------------------------S---E-------------------SS---XX-----------------QQQ-----ESSS----E----<>-------------------E---------
-------XXX---------------------------------X---------------E-----<>------------XX--------------------------------<>------------------------<>--X------
---E---XXX-----------------------------E---X---------------------[]------------XX------------------E-------------------------------------------X-S-S--
-------XXX-----X---------------------------X---------------------[]E-----------XX--------X-----------------------------------------------------X-S-S--
XXXXXXXXXX--XXXXXXXXXXXXX--XXX--XXXXXXXXX--XXXXXXXXXXXXXXXXXXXXXXXXXXXXXXXXXXXXXXXXXXXXXXXXXXXXXXXXXXXXXXXXXXXXXXXXXXXXXXXXXXX---XXXXXXXXXXXXXXXXXXXXX
