------------------------------------------------------------------------------------------------------------------------------------------------------
------------------------------------------------------------------------------------------------------------------------------------------------------
------------------------------------------------------------------------------------------------------------------------------------------------------
------------------------------------------------------------------------------------------------------------------------------------------------------
------------------------------------------------------------------------------------------------------------------------------------------------------
------------------------------------------------------------------------------------------SSSSSSS--------------------------------------------------SSS
B-----------------------------------------------------------------------------------------------------------------------------------------------------
b-----------------------------------------------------------------------------------------------------------------------------------------------------
-------------------------------------------------------------------------------------------E--E--X---------X-EE-----X-------------ooo---------------E-
SSSSSS---------------------------------------------ooo------------------------------------SSSSSSSX---------XSSSSSSSQX-------------ooo-----------E--SSS
---------------------------------------------------------------------------------Q?QQQ---------------------------------------------------------<>-----
-----------------------E------------------------------------------------------------------------------------------------------------------------------
-EE---X----------------------------------EE-------------------EE--------------------------------------------------------------------------------------
XXXXXXX---XXX--XXXXXXXXXX--XXXXXXXXXXXXXXXXXXXXXXXXXXX--XXXXXXXXXXXXXXXXXXXXXXXXXXXXXXXXXXXXXX--XXXXXXXX--XXXXXXXXXXXXXEEXEXXXXXXXXXXXXEEXEXXXXXXXXXXX
