------------------------------------------------------------------------------------------------------------------------------------------------------
------------------------------------------------------------------------------------------------------------------------------------------------------
------------------------------------------------------------------------------------------------------------------------------------------------------
-----------------------------------------------------------------------------------------------------------E------------------------------------------
------------------------------------------------------------------------------------------------------------------------------------------------------
-----------XXX--------------------SSSS-----------------------XXXX-------------------------------------XXXXEXXXXX------------XXXXXXXXXXXXXXX-----------
E---------XEXX-------------------------------------------------------------------XX--------------------------------------------[]-------[]------------
---------EXXXX------------------------------------------------------------------XXX--------------------------------------------[]-------[]------------
--------EXXXXX-----------------------------------------------------------------XXXX--------------------------------------------[]-------[]------------
-------XXXXXXX-------------------------XX---------------------------<>--------XXXXX----------------XXXXEXEEXXXXXXX-------------[]-------[]--------<---
------XXXXXXXX-------------------------XX---------------------------[]-------XXXXXX--------------------------------------------<>-------<>--------[]--
-----XXXXXXXXX------------B------------XX------------B--------------[]------XXXXXXX--------------XX-----------------------------------------------[]--
----XXXXXXXXXX------------b-----------EXX------------b--------------[]-----XXXXXXXX----------------------------------B----------E--------E--------[]--
XXXXXXXXXXXXXXXXXXXXXXXXXXXXXXXXXXXXXXXXX------XXXXXXXXXXXXXXXXXXXXXXXXXXXXXXXXXXXX-------XXXXXXXXX--------------XXXXXXXXXXXXXXXX-XXXXXXXX-XXXXX--XXXX
