------------------------------------------------------------------------------------------------------------------------------------------------------
------------------------------------------------------------------------------------------------------------------------------------------------------
------------------------------------------------------------------------------------------------------------------------------------------------------
------------------------------------------------------------------------------------------------------------------------------------------------------
-ooo--E-----------------------------------------------------------------------------------------------------------------------------------------------
SSSSSSSSSSSSS--------SSSSSSS------------------SSSSSSS---------------E------E------------------------------SSSSS---------SSS---------------------------
-----------------------------------------------------------------E---------------------------------------S--------------------------------------------
---------------------------------------------------------------------------------------E----------------SS--------------------------------------------
-----------------------------------------------E--E-----------XSSSSSSSSSSSS------------]---------------SSS--------------------------------------------
SSSSSSSSSS----------------SSS-----------------SSSSSSS--------XX-----o-----------------QQ--------------SSSS--------------------------------------------
--------------------------------?-B----?QQ------------------XXX----oooooo-----------------B---------------------SS------------------E--<>-------------
---------------------B------------b------------------------XXXX----------S----------------b---------------------SS--------------B------[]----<>-----B-
--E------------------b------------------------------------XXXXX----ooooooS----------------BEE---------B---------SS---------------------[]-E--[]-------
XXXXXXXXXXX---XXXXXXXXXXXXXXXXXXXXXXXXXXXXXXXXXXXX--XXXXXXXXXXXXXXXXXXXXXXX-----X--XXXXX--XXXXXXXXXXXXXXXXXXXXXXXXXXXXXXXXXXXXXXXXXXXXXXXXXXXXXXXXXXXX
