------------------------------------------------------------------------------------------------------------------------------------------------------
------------------------------------------------------------------------------------------------------------------------------------------------------
SSSSSSSSSSSSSSSSSSSSSSSSSSSSSSSSSSSSSSSSSSSSSSSSSSSSSSSSSSSS-SS---------------------------------------------------------------------------------------
SS-----------SSSSSSSSSSS----SSSS------SSSS------------------------------------------------------------------------------------------------------------
SS-----------SSSSSSSSSSS----SSSS--E---SSSS------------------------------------------------------------------------------------------------------------
SS-----------SSSSSSSSSSS-----S----SS---------QQ-------------XXX----------XXXXXXXXXXXXXXXX-----------------------------------------------E-------------
-----------------------------S----SS------------------------------------------------------------------------------------------------E-----------------
-----------------------------S----SS------------------------------------------------------------------------------------------------------------------
-----------------------------So??-SS---E--------------------------------------------------------------------------------------------------------------
SS-------------SSSSSS--------SSS--SS--SSSS------------------------------------------------------------------------------------------------------------
-------------------------------------EE-------------------------------------------------------------------B------------------E---------------E--------
------<>--------------------------------------------------------------------------------------------------b-------------------------------------------
o---E-[]---------------E----------------------------B--------------------------S---------------E----------BEE------------------------------------X----
XXXXXXXXXXX---XXXXXXXXXXXXXXXXXXXXXXXXXXXX---XXXXXXXX--XXXXXXXXXX-----XXXXXXXXX--XX--XX--XXXXXXXXXXXXXXXXXXXXXXXXXXXXXXXXXXXXXXXXXXXXXXXXXXXXXXXXX----
