------------------------------------------------------------------------------------------------------------------------------------------------------
------------------------------------------------------------------------------------------------------------------------------------------------------
----------------------------------------------------------------------------------------------------SS------------------XXXX------------------------SS
-------------------------------------------------------------<>-------------------------------------[]-------------------[]-------------------------[]
-------------------------------------------------------------[]-------------------------------------[]-------------------[]-------------------------[]
---------------XX--------------SSSS------------------------XX[]X------------------------------------<>-------------------[]-------------------------[]
--------E--E---[]--------------------------------------------------------------------------------------------------------[]-------------------------[]
---------------[]-------------------------------------------------------------E----------------------E-------------------[]-------------------------[]
-----E---------[]--------------------------------------------------------------------------------------------------------[]-------------------------[]
---------------[]-------------------<>---------------XEXXX-----------------------------------------<>---QQQQQ?QQQQQQQ?Q--<>------X------------------[]
---------------<>-----B-------------[]----------------------------------------------XX-------------[]----------------------------X------------------[]
----------------------b-------------[]---------------------------------------------XXX-------------[]----------------------------X------------------[]
X---------------E-----B-------------[]---------------------------------X----------XXXX-------------[]---------------------------EX------------------[]
X-------------XXXXXXXXXXXXXXXXXXXXXXXXXXXXXXXXXEEXEXX-----------------XXXXXXXXXXXXXXXXXXXXXXXXXXXXXXXXXXXXXXXEEXXXXXEXEXXXXXXXXXXX-----XXXEXXXXXXXXXXX
