------------------------------------------------------------------------------------------------------------------------------------------------------
------------------------------------------------------------------------------------------------------------------------------------------------------
-------------------------------------------------------------------------------------------------------------SSSSSSSSSSSSSSSSSSSSSSSSSSSSSSSSSSSSSSSS[
------------------------------------------------------------------------------------------------------------------------SSSSSSSSSSSSSSSSSSSSSSSS------
------------------------------------------------------------------------------------------------------------------------SSSSSSSSSSSSSSSSSSSSSSSS------
SQ-----------------------SSSQ--------------?---------SSSS--------SSS----SQQS--------------------------------------------SSSSSSSSSSSSSSSSSSSSSSSS--QQ--
------------------------------------------------------------------------------------------------------------------------------------------------------
------------------------------------------------------------------------------------------------------------------------------------------------------
-------------------------------------------------------------------------------------------------------------------------------?----------------------
-QQQ------------------------S-----SS----Q--Q--Q--Q-----------------------SS------X--X----------XX--X----------------------SSSSS??SSSSSSSSSSSSSSS--QQ--
--------------------------------------------------------------------------------XX--XX--------XXX--XX---------------------SSSS---SSSSSSSSSSSSSS-------
-------------------------------------------------------------------------------XXX--XXX------XXXX--XXX-----<>-------------SSSS---SSSSSSSSSSSSSS-------
------------------------------------------------------------------------------XXXX--XXXX----XXXXX--XXXX----[]-----------------oooSSSSSSSSSSSSSS-------
XXXXXXXXXX---XXXXXXX--X-XXXXXXXXXXXXXXXXXXXXXXXXXXXXXXXXXX---XXXXXXXXXXXXXXXXXXXXXXXXXXXXXXXXXXXX--XXXXXXXXXXXXX--XX-----XXXXXXXXXXXXXXXXXXXXXXXXXXXXX
