------------------------------------------------------------------------------------------------------------------------------------------------------
------------------------------------------------------------------------------------------------------------------------------------------------------
SSSSSSSSSSSSSSSSSSSSSSSSSSSSSSSS----------SSSSSSSSSSSSSSSSSSSSSSSSSSSSSSSSSSSSSSSSS-------------------------------------------------------------------
SSSSSSSSSSSSSSSSSSSSSSS--------------------------------------------------------[]---------------------------------------------------------------------
SSSSSSSSSSSSSSSSSSSSSSS-----------XXX------------------------------------------[]---------------------------------------------------------------------
SSSSSSSSSSSSSSSSSSSSSSS--QQ------------SSS-----------E-------------------------[]-----------------------------------------------------------------X---
----------------------------------------------------<>-------------------------[]----------X--EX-------------------------------------------------XX---
---------------------------------------S------------[]-------------------------<>----------X---X------------------------------------------------XXXXX-
---?----------------------------------S-S-----------[]--------------E----------------X---X-X---X--------XXEE----X--------------ooo-------------XXXX---
SSS??SSSSSSSS----SSSSSS--QQ--QQQ---------S-----E--SS[]-------------<>----------------XSSSX-XSS?X--------XSSSSSSSX--------------ooo------------XXXXX---
S----SSSSSSSSSSSSSSSSSS-----------------------<>----[]-------------[]---<>----S-S-S----------------------------------------------------------XXXXXX---
S----SSSSSSSSSSSSSSSSSS-----------------------[]----[]-------------[]---[]----S-S-S---------------------------------------------------------XXXXXXX-E-
-<oooSSSSSSSSSSSSSSSSSS-----------------------[]-E--[]---ooooooo---[]---[]----S-S-S--------------------------------------------------------XXXXXXXX<>-
XXXXXXXXXXXXXXXXXXXXXXXXXXXXXXXX------XXXXXXXXXXXXXXXXX--XXXXXXX---[]---[]----S-S-SXXXXXXXXXXXXXXXXXX--XXXXXXXXXXXXEEXXEXXXXXXXXXXXXXXXXXXXXXXXXXXX[]-
