------------------------------------------------------------------------------------------------------------------------------------------------------
------------------------------------------------------------------------------------------------------------------------------------------------------
------------------------------------------------------------------------------------------------------------------------------------------------------
------------------------------------------------------------------------------------------------------------------------------------------------------
------------------------------------------------------------------------------------------------------------------------------------------------------
----------------SSSSSSS--------------SS-----E----------------------------------------------------------------------------------------?--X-------------
--------------------------------------------------------------------------------------------------E-------------------------------------X-------------
-------------------------------------------------E--------------------------------------------------------------------------------------X-------------
-----------------------------------?------------<>---------------------------------------------E-----B-----------------------------XQE--X-------------
<>----------------------------------------------[]-----------------------------------------------------------oooooooooo-----------XX--QQX-------------
[]------------------B----------------B----------[------------------------------------------------------------oooooooooo-----------XX------------------
[]-------B----------b----------B-----b--------------------------E-----------------------------------------------------------------XX----E-------------
[]-------b----------BEE---------------------------------------------------------EE--------X---------------XXXXXXXXXXXEXXXX-------------------------XXX
XXXXXXXXXXXXXXXXXXXXXXXXXXXXXXXXXXXXXXXXXXXXXXXXXXXXX---XXXXXXXXXX--XXXXXXXXXXXXXXXXXXXXXXX---------------XX-------------XXXXXXXXXXXXXXXXXXXXXXXX-----
