------------------------------------------------------------------------------------------------------------------------------------------------------
------------------------------------------------------------------------------------------------------------------------------------------------------
--------------------------------------------------------------------------------------------------------------------------------------------------SSS-
-----------------------------------------------------------------------------XXXXXX------------------------------------------------------->-----------
-----------------------------------------------------------------------------XX--------E---------------------------E----------------------]-----------
-------E----------XXXX------------------------E-E-E----------------------S---XX----------XXXXXXX--------XXXXXX-------XXXXXX--------XX-----XX----------
------<>-------------------------------------<><><>--------------------------XX-----------------------------------------------------------------------
------[]-------------------------------------[][][]--------------------------XX-----------------------------------------------------------------------
------[]----------------------------------?--QQQQQQ-----------------------S--XX-----------------------------------------------------------------------
------XXX---<>---------------------------Q------------------Q----------------XX-----------------------------------------------------------------------
------------[]--------E------------------------------------------------------XX-------------------------------------------------------------------SSSS
-------X----[]-------<>---------------------------------<>---------<>--------XX-------------------------------------------------------------------SSSS
------------[]-------[]--------X------------------------[]---------[]---E----XX-------------------------------------------------------------------SSSS
X----XXXXXXXXXXXXXXXXXXXXXXXXXXXXXXXXXXXXXX--XXXXXXXXXXXXXX-XXX----XXXXXXXXXXXXXXXX--------------------------------------------------X------------XXXX
