------------------------------------------------------------------------------------------------------------------------------------------------------
------------------------------------------------------------------------------------------------------------------------------------------------------
------------------------------------------------------------------------------------------------------------------------------------------------------
------------------------------------------------------------------------------------------------------------------------------------------------------
------------------------------------------------------------------------------------------------------------------------------------------------------
------E--S---SSSSSSSSSS---E----------------------------------------XS---------------------------------------------------------------------------------
-----<>------------------<>---------------------------------------EX----------------------------------------------------------------------------------
-----[]------------------[]-------------------------------S------XXX----------------------------------------------------------------------------------
-----[]------------------XXX------------------------------------XXXXS-------------------------B-------------------------------------------------------
-----XXS------------<>----------------<>---S---SSSS----<>------XXXXX------------------B-------b---------------<>--------------------------------------
--------------------[]----------------[]-------SSSS----[]-----XXXXXX------------------b--?-B------?QQ---------[]-------QQQoQQ?------------------------
---------<>---------[]-------<>-------[]-------SSSS----[]----XXXXXXX------------------B----b------------------[]--------------------------------------
---------[]---------[]------X[]-------[]---------------[]---XXXXXXXX---------X--------------------------------[]-------------------X-----X-----X------
X---XXXXXXXX-XXXX--XXX--XXXXXXXXXXXXXXXXXXXXXXXXXXXXXXXXXXXXXXXXXXXXXXXXXXXX-XXXXXXXXXXXXXXXXXXXXXXXXXXXXXXXXXXXXXXXXXXXXXXXXXXXXXXX-----X-----XXXXXXX
