----------------------------------------------------------------------------------------------------------------------------------------------------------------------------------------------------------------
----------------------------------------------------------------------------------------------------------------------------------------------------------------------------------------------------------------
----------------------------------------------------------------------------------------------------------------------------------------------------------------------------------------------------------------
----------------------------------------------------------------------------------------------------------------------------------------------------------------------------------------------------------------
----------------------------------------------------------------------------------------------------------------------------------------------------------------------------------------------------------------
----------------------------------------------------------------------------------------------------------------------------------------------------------------------------------------------------------------
----------------------------------------------------------------------------------------------------------------------------------------------------------------------------------------------------------------
-------------------------XXX----------------------------------------------------------------------------------XX------------------------------------------S-----------------------------------------------------
-------------------------XXX---------------------------------------------------------------------------------XXX-------------------------E----------------------------------------------------------------------
-------------------------XXX--------------------------------------------------------------------------------XXXX-------------------------------------------------------------------X----------------------------
----------------------X--XXX-------------------------------------------------------------------------------XXXXX------------------------------------------EE--E-------------------XX--oo---------o--------------
----------XX---------XX--XXX------------S-------------XXXXX-----------------------------------------------XXXXXX-------------XX---XXX---------------XX---XXXXXXXX----------------XXX----------------------------
---------XXX--------XXX--XXX-------------------------XXX-------------------------------------------------XXXXXXX------------XXX-E------------------XXX----------X---------------XXXX-------------------------E--
--------XXXX-------XXXX--XXX------------------------XXXX------------------------------------------------XXXXXXXX-----------XXXX-------------------XXXX----------X--------------XXXXX-------------------XXXXXXXXX
-------XXXXX------XXXXX--XXX---------X-------------XXXXX-----------------------------------------------XXXXXXXXX----------XXXXX------------------XXXXX----------X-------------XXXXXX-------------------X--------
XXXXXXXXXXXX---XXXXXXXX--XXXXXXXXXXXXXXXXXXXXXXXXXXXXXXX---XXXXXXXXXXXXXXXXXXX-XX-----X--XXXXXXXXXXXXXXXXXXXXXXXXXXXXXXXXXXXXXX----------X---XXXXXXXXXXXXXXXXXXXXXX--XXXX-XXXXXXXXXXXXXXXXXXXX-X--XXXXXX--------