----------------------------------------------------------------------------------------------------------------------------------------------------------------------------------------------------------------
----------------------------------------------------------------------------------------------------------------------------------------------------------------------------------------------------------------
----------------------------------------------------------------------------------------------------------------------------------------------------------------------------------------------------------------
-------------SSSSSSSSSSSSSS-------------------------------------------------------------------------------------------------------------------------------------------------------------------------------------
----------------------------------------------------------------------------------------------------------------------------------------------------------------------------------------------------------------
-----------E----------------------------------------------------------------------------------------------------------------------------------------------------------------------------------------------------
----S-SSSSS---------------------------------------------XX-------------------------------------------------------------------------------------------XX----------------------XXX--------------------------------
--------------------------------------------------------XX-----------------------------------------------------------------X------------------------XXX----------------------XXX--------------------------------
------------------------------------------------------XXXX-----------------------------------------------------------------------------------------XXXX--------------------XXXXX--------------------------------
-----------------------X------------------------------XXXX------------------------------------------------------------------------------X---------XXXXX--------------------XXXXX--------------------------------
XXXX--SSSSS-----------------------------------------XXXXXX---------------------XX-----------------------------------------------------XXX--------XXXXXX------------------XXXXXXX--------SSSSSSS-----------------
XXXX------------------------------------------------XXXXXX-------E------------XXX-----------------------------------------------------XXX-------XXXXXXX------------------XXXXXXX--------------------------------
XXXX------------------------------------------------XXXXXX--------------------XXX---------------------------------------------------XXXXX------XXXXXXXX----------------XXXXXXXXX--------------------------------
XXXX-----E--E---X-----------------------------------XXXXXX-------------X----XXXXX--------------------------X-----------------------XXXXXX-----XXXXXXXXX---------------XXXXXXXXXX-------------------------------X
XXXXXXXXXXXXXXXXX-------------XXXXXXXXXXXXXXXXXXXXXXXXXXXXXXXXXXXXXXXXXX----XXXXXXXXXXXXXXXXXXXXXXXXXXXXXXXX----------------------XXXXXXXXXXXXXXXXXXXXXXXXXXXXXXXXXXXXXXXXXXXXXXXXXXXXXXXXXXXXXXXXXXXXX-----XXXX
XXXXXXXXXXXXXXXXX-------------XXXXXXXXXXXXXXXXXXXXXXXXXXXXXXXXXXXXXXXXXX----XXXXXXXXXXXXXXXXXXXXXXXXXXXXXXXX----------------------XXXXXXXXXXXXXXXXXXXXXXXXXXXXXXXXXXXXXXXXXXXXXXXXXXXXXXXXXXXXXXXXXXXXX-----XXXX