----------------------------------------------------------------------------------------------------------------------------------------------------------------------------------------------------------------
----------------------------------------------------------------------------------------------------------------------------------------------------------------------------------------------------------------
----------------------------------------------------------------------------------------------------------------------------------------------------------------------------------------------------------------
----------------------------------------------------------------------------------------------------------------------------------------------------------------------------------------------------------------
----------------------------------------------------------------------------------------------------------------------------------------------------------------------------------------------------------------
----------------------------------------------------------------------------------------------------------------------------------------------------------------------------------------------------------------
-----------------------------------------X---------XXX------------XX---------------------------------------------------------E--SSS-----------------------------------------------------------------------------
----------------------------------------XX---------XXX------------XX-------------------------------------------X----XX------------------------------------------------------------------------------------------
---------------------------------------XXX---------XXX----------XXXX------------------------------------------XX------------------------------------------------------------------------------------------------
--------------------------------------XXXX---------XXX----------XXXX-----------------------------------------XXX-------------------------E------------------------------------------------XXX-------------------
-------------------------------------XXXXX---------XXX--------XXXXXX----------------------------------------XXXX------------------------<>----------------------------------------------X------------X----------
------------------------------------XXXXXX---------XXX--------XXXXXX---------------------------------------XXXXX------------------------[]----------------------------------------------------------XX----------
-----------------------------------XXXXXXX---------XXX--------XXXXXX--------------------------------------XXXXXX------------------------[]----------------------------------------------X---------XXXX----------
--------------------X-------------XXXXXXXX---------XXX----E---XXXXXX-------------------------------------XXXXXXX------------------------[]-E----------------E-----------------------E---X---------XXXX----------
XXXXXXXXXXXXXXXXXXXXX------------XXXXXXXXXXXXX-----XXXXXXXXXXXXXXXXXXXXXXXXXXXXXXXXXXXXXXXXXX--------XXXXXXXXXXXXX-----------XXXXXXXXXXXXXXXXXXXXXXXXXXXXXXXXXXXXXXXXXXXXXXXXXXXXXXXXXXXX---------XXXXXXXXXXXXXX
XXXXXXXXXXXXXXXXXXXXX------------XXXXXXXXXXXXX-----XXXXXXXXXXXXXXXXXXXXXXXXXXXXXXXXXXXXXXXXXX--------XXXXXXXXXXXXX-----------XXXXXXXXXXXXXXXXXXXXXXXXXXXXXXXXXXXXXXXXXXXXXXXXXXXXXXXXXXXX---------XXXXXXXXXXXXXX