----------------------------------------------------------------------------------------------------------------------------------------------------------------------------------------------------------------
----------------------------------------------------------------------------------------------------------------------------------------------------------------------------------------------------------------
----------------------------------------------------------------------------------------------------------------------------------------------------------------------------------------------------------------
----------------------------------------------------------------------------------------------------------------------------------------------------------------------------------------------------------------
---------------------------------------------------------------------------------------------------------------------------------------------------------SSSSSSSSSSSSSSSSSSSSSSSSS------------------------------
----------------------------------------------------------------------------------------------------------------------------------------------------------------------------------------------------------------
---------------------------------------------------------------------------------------------------------------------------------------XX-------------------------------------------XXX-------------------------
--------------------XX-----------------------------------------XX---------------------------------------------------------------------------SSS------------------------------------------SSS--------------------
--------------------XX----------------------------------------XXX-----------------------------------------------------------------------------------------------------------------------------------------------
--------------------XX-----------------XSS--------------------XXX-----------------------------------------------------------------------------------------------------------------------------------------------
-----------------X--XX----------------XX---o-------XX-------X-XXX---------------------------------------------------------------XXX--------SSSS-----------------------------------------------------------------
-X---------------X--XX---------------XXX----------XXX------XX-XXX----------------------------------X--X-------------------------------------------------------------X-X--------------------------------S--------
XX--XX------E--XXX--XX--------------XXXX---------XXXX------XX-XXX---------------------------------XX--XX----------------------------------------------------------X-X-X-X---------------------------------------
XX--XX--------XXXX--XX-------------XXXXX--------XXXXX----X-XX-XXX--------------------------------XXX--XXX--------------------X----------------------------------X-X-X-X-X---------------------------------------
XX-----------XXXXX--XX------------XXXXXX---SS---XXXXX---XX-XX-XXX-------------------------------XXXX--XXXX----------------------------------E----------------E-EX-X-X-X-X-E----------------E--------------------
XX------XXXXXXXXXX--XXXXXXXXXXXXXXXXXXXX-----XXXXXXXXXXXXX-XX-XXXXXXXXXXXX-XXXXXXXXXX--XXXXXXXXXXXXXXXXXXXXXXX---------------X------------XXXXXXXXXXXXXXXXXXXXXXXXXXXXXXXXXXXXXXXX------XXXXXXXXXXXXXXXXX-XXX-XX