----------------------------------------------------------------------------------------------------------------------------------------------------------------------------------------------------------------
----------------------------------------------------------------------------------------------------------------------------------------------------------------------------------------------------------------
----------------------------------------------------------------------------------------------------------------------------------------------------------------------------------------------------------------
----------------------------------------------------------------------------------------------------------------------------------------------------------------------------------------------------------------
----------------------------------------------------------------------------------------------------------------------------------------------------------------------------------------------------------------
-----------------------------------------------------------------------------------------------------------------------------------------------------------------------------------------------oooooo-----------
---------------------------------------------------------------------------------------------------------------------------------------------------------------------------------------------SSSSSSSSSSSS----SSS
--------------------------------------------XX-------------------------------------------------------------------XX--------------------------------X-----------XX-----------------------------------------E-----
-------------------------------------------XXX-------------------------------------------------------------------XX-------------------------------XX-----------XX-----------------------------------------------
------------------------------X-----------XXXX----------------------------------X--------------------------------XX------------------------------XXX-----------XX-----------------------------------------------
-----------------------------XX----------XXXXX---------------------------------XX-----------------------------X--XX-----------------------------XXXX--------X--XX-----------------------------SSSSSSSSSSS--X----
----------------------------XXX---------XXXXXX-------------------XX---------X--XX------------XX---XXX---------X--XX---------XX-----------------XXXXX-------XX--XX-----------------------------------------XX----
--------------------E------XXXX--------XXXXXXX-----------------XXXXX-------XX--XX-----------XXX-------------X-X--XX--------XXX----------------XXXXXX------XXX--XX----------------------------------------XXX----
--------------------------XXXXX-------XXXXXXXX----------------XXXXXX------XXX--XXX---------XXXX-------------X-X--XX--------XXX---------------XXXXXXX-----XXXX--XX----------------------------------E---XXXXX----
-------------------------XXXXXX-E----XXXXXXXXX---------------XXXXXXX----XXXXX--XXX--------XXXXX-------------X-X--XX--------XXX--------------XXXXXXXX----XXXXX--XX---------------------------XXXXXXXXX-XXXXXX----
XXXXXXXXXXXXXXXXXXXXXXXXXXXXXXXXXXXXXXXXXXXXXXXXXXXXXX----XXXXXXXXXXXXXXXXXXX-XXXXXXXXXXXXXXXXX--------XXXX-X-X--XXXXXXXXXXXXXXX----XX----XXXXXXXXXXXXXXXXXXX--XXXXXXXXXXXXXXXXXXXXXXXX---XXXXXXXXXXXXXXXXXXXXXX