----------------------------------------------------------------------------------------------------------------------------------------------------------------------------------------------------------------
----------------------------------------------------------------------------------------------------------------------------------------------------------------------------------------------------------------
----------------------------------------------------------------------------------------------------------------------------------------------------------------------------------------------------------------
----------------------------------------------------------------------------------------------------------------------------------------------------------------------------------------------------------------
----------------------------------------------------------------------------------------------------------------------------------------------------------------------------------------------------------------
----------------------------------------------------------------------------------------------------------------------------------------------------------------------------------------------------------------
------------------------------------------------------------X-------------------------------------------------------------------------------------------------------------------------------X-----------------S-
-----------------------------------------------------------XX------E---------------------------------------------------------------------------------------------------------------------E--X-------------------
----------------------------------------------------------XXX----------------------------------------------------------------------------------------------------------------------------X--X-------------------
---------------------------------------------------------XXXX-------------------------------------------------------------------------------------------------------------------------E--X--X-------------------
------------------------XX------------------------------XXXXX-------------------------------------------------------------------------------------------XX--S--------------E----------X--X--X-------------------
-----------------------XXX-------------------E---------XXXXXX---------------------------------------------------------X-----X--------------------------XXX------------------E---------X--X--X-------------------
----------------------XXXX------------------<>--------XXXXXXX-------------------------------------------------------XXXX------------------------------XXXX----------------------------X--X--X-------------------
---------------------XXXXX------------------[]-------XXXXXXXX-----------------------------------EE------------------XXXXX----------------------------XXXXX-------------------------X--X--X--X-------------------
--------------------XXXXXXXXXXXXXXXXXXXXXXXXXXXXXXXXXXXXXXXXX-----------XXXXXXX---XXXXXXXXXXXXXXXXXXXXXXXXXXXXXXXXXXXXXXX---------------------------XXXXXX--XXXXXXXXXXXXXXXXXXXXXXXX--X--X--X--XXXXXXXXXXXXXXXXX
--------------------XXXXXXXXXXXXXXXXXXXXXXXXXXXXXXXXXXXXXXXXXX--------X-XXXXXXX---XXXXXXXXXXXXXXXXXXXXXXXXXXXXXXXXXXXXXXX---------------------------XXXXXX--XXXXXXXXXXXXXXXXXXXXXXXX--X--X--XX-XXXXXXXXXXXXXXXXX