----------------------------------------------------------------------------------------------------------------------------------------------------------------------------------------------------------------
----------------------------------------------------------------------------------------------------------------------------------------------------------------------------------------------------------------
----------------------------------------------------------------------------------------------------------------------------------------------------------------------------------------------------------------
--------------------------------------------------------------------------------------------SSSSSSSSSSSSSSSSSSSSSS---------------------------SSSSSSSSSSSSSSSSSSSSSSSSS------------------------------------------
-------------------------------------SSSSSSSSSSS-------------------------------------------------------------------------------------------S--------------------------------------------------------------------
----------------------------------------------------------------------------------------------------------------------------------------------------------------------------------------------------------------
---------------------------XX---------------------------------------------------------------------------------------------------------------------------------------------SSSSSSSSSSS---------------------------
--------------------------XXX----------------------------------------XX-----------------------------------------------------------------------------------------------------------------------------------------
-------------------------XXXX---------------------------------------XXX-----------------------------------------------------------------------------------------------------------------------------------------
------------------------XXXXX--------------------------------------XXXX----------------------------XXXXX-------------------------------------XXXXX-----------------------------E--------------------------------
-----------------------XXXXXX-------------------------------------XXXXX---------------------------XXXXXX--------------XXXXXXX---------------XXXXXX------------------------SSSSSSSSSSS---------------------------
----------------------XXXXXXX----------------XX----XXX-----------XXXXXX--------------------------XXXXXXX--------------XXXXXXX--------------XXXXXXX----------------------------------------X--XX----XXX----------
---------------------XXXXXXXX---------------XXXXX---------------XXXXXXX-------------------------XXXXXXXX---XXXX-------XXXXXXX-------------XXXXXXXX---XXX---------------------------------XXXXXXXX---------------
-----------X--------XXXXXXXXX-------------XXXXXXX--------------XXXXXXXX------------------------XXXXXXXXX--------------XXXXXXX------------XXXXXXXXX------------------------------E-------XXXXXXXXX---------------
XXXXXXXXXXXX-------XXXXXXXXXXXXXXXXXXXXXXXXXXXXXX-------------XXXXXXXXXXXX--------------------XXXXXXXXXXX-------------XXXXXXXXXXXXXXXXXXXXXXXXXXXXXXX----------------XXXXXXXXXXXXXXXXX--XXXXXXXXX---------------
XXXXXXXXXXXX----X--XXXXXXXXXXXXXXXXXXXXXXXXXXXXXX------------XXXXXXXXXXXXXXX---X--------------XXXXXXXXXXX-------------XXXXXXXXXXXXXXXXXXXXXXXXXXXXXXX----------------XXXXXXXXXXXXXXXXX--XXXXXXXXX---------------