----------------------------------------------------------------------------------------------------------------------------------------------------------------------------------------------------------------
----------------------------------------------------------------------------------------------------------------------------------------------------------------------------------------------------------------
----------------------------------------------------------------------------------------------------------------------------------------------------------------------------------------------------------------
-------------------------------------------SSSSSSSSSSSSSS-------------------------------------------------------------------------------------------------------------------------------------------------------
----------------------------------------SS-------------------------------------------------------SSSSSSSSSSSSSSSS---------------------------------------------SSSSSSSSSSSSSSSSSSSSSSSSSSSSSS--------------------
----------------------------------------------------------------------------------------------------------------------------------------------------------------------------------------------------------------
------------------------------------------------------------------------------------------X------------------------XXX----------SSSSSSSSSSSSSS------------------------------------------------XX----------------
-----------------------------------------------------------------------------------------XX---------------------------------------------------------------------------------------------------------------------
----------------------------------------------------------------------------------------XXX-------------------------------------------------------------XXXXX---------------------------------------------------
------------------------------------------XXXXX----------------------------------------XXXX---------------------------------------------E-------------XXXX------------------------------------------------------
-----------------------------------------XXXXXX---------------------------------------XXXXX------------------------------------------SSSSSSSSS-------XXXXX------------------------------------------------------
-X--------------------------------------XXXXXXX--------------------------------------XXXXXX---SQQQ-------------XX-----------------------------------XXXXXX--------------QQQQQQ----------------------------------
-X-------------------------------------XXXXXXXX---XXX-------------------------------XXXXXXX------------------EXXX--XXX-----------------------------XXXXXXX------------------------------------------------------
-XX-----------------------------------XXXXXXXXX------------------------------------XXXXXXXX-----------------EXXXX--------------------------E------XXXXXXXX------------------------------------------------------
XXXXXXXXXXXXXXXXXXXXXXXXXXXXXXXXXXXXXXXXXXXXXXXX----------------------XXXXXXXXXXX-XXXXXXXXX-----------------XXXXX---------XXXXXXXXXXXXXXXXXXXXX-XXXXXXXXXX-------------------EE-E------------------XXXXXXXXXXXXX
XXXXXXXXXXXXXXXXXXXXXXXXXXXXXXXXXXXXXXXXXXXXXXXXX---------------------XXXXXXXXXXXXXXXXXXXXXXXXXXXXXXX-XXXXXXXXXXX------X--XXXXXXXXXXXXXXXXXXXXX-XXXXXXXXXXXXX--XX--XXXXXXXXXXXXXXXXXX-XXX-X--------XXXXXXXXXXXXX