----------------------------------------------------------------------------------------------------------------------------------------------------------------------------------------------------------------
----------------------------------------------------------------------------------------------------------------------------------------------------------------------------------------------------------------
----------------------------------------------------------------------------------------------------------------------------------------------------------------------------------------------------------------
----------------------------------------------------------------------------------------------------------------------------------------------------------------------------------------------------------------
-----------------------------------------E----------------------------------------------------------------------------------------------------------------------------------------------------------------------
----------------------------------------------------------------------------------------------------------------------------------------------------------------------------------------------------------------
----------------------------------------------------------------------------------------------------------------------------------------------------------------------------------------------------------------
------------------------------------------XX---------------------------------------------------------XX---------------------------------------------------------------------------------------------------------
-------------------------------------E---XXX--------------------------------------------------------XXX---------------------------------------------------------------------------------------------------------
-----------------------------------------XXX----------------------------XX--------------X----------XXXX----------------------------X----------------------------------------------------------------------------
---------------------------------------X-XXX------------XXXX------------XX-------------XX---------XXXXX---------------------------XX---------------------ooo------EE--------------------------------------------
---------------------------------------X-XXX----------------------------XX------------XXX--------XXXXXX---------------------------XX---------------------------XXXXXX-------------------------------------------
-------------------------------------X-X-XXX----------------------------XX-----------XXXX-------XXXXXXX------------------E------X-XX--------------------------X-----X---X---------------------------------------
XXX---------------------------------XX-X-XXX----------------------------XX----------XXXXX------XXXXXXXX------------------------XX-XX--------------------------X-----X---X---------------------------------------
-----------------------------------XXX-X-XXX----------------------------XX---------XXXXXX-----XXXXXXXXX-----------------------XXX-XXE-------------------------X-----X---X-----E---------------------------------
-------------------------XXXXXXXXXXXXX-X-XXXXXX-------------------------XXXXXXXXXXXXXXXXXXXXXXXXXXXXXXXXXXXXXXXXXXXXXXXXXXXXXXXXXXXXXXXXXXXXXXXXXXXXXXXXXXXXXXX-----X---X---XXXXXXXXXXXXXXXXXX-XXXXXXXXX-------X