----------------------------------------------------------------------------------------------------------------------------------------------------------------------------------------------------------------
----------------------------------------------------------------------------------------------------------------------------------------------------------------------------------------------------------------
----------------------------------------------------------------------------------------------------------------------------------------------------------------------------------------------------------------
----------------------------------------------------------------------------------------------------------------------------------------------------------------------------------------------------------------
----------------------------------------------------------------------------------------------------------------------------------------------------------------------------------------------------------------
----------------------------------------------------------------------------------------------------------------------------------------------------------------------------------------------------------------
---------------------------------------------------------------------------------------------------------------------------------------------------------------------------------------------------------------X
-------------XX-------------XX-----------------------------------------------------------------------------------------------------------XX-------------------------------------------------------------------XX
------------XXX------------XXX-----------------------------------------------------------------------------------------------------------XX------------------------------------------------------------------XXX
-----------XXXX-----------XXXX-----------------------------------------------------------------------------------------------------------XX------------------------------------------------------------------XXX
---------X-XXXX----------XXXXX--------------------------------------------------------------------------------------------------------X--XX--------------------------E-------------------------------------X-XXX
--------XX-XXXX---------XXXXXX------------------------------------------------------------------------------------------XXXX---------XX--XX------------XX------XXXXXXXX-----------------------------------XX-XXX
----E--XXX-XXXX---------XXXXXX---------------------------------------------------------------------------E-----E-------XX--------E--XXX--XX-----------XXX------X-----------------------------------------XXX-XXX
------XXXX-XXXX-------X-XXXXXX----------------------------------------------------------------------------------------XXX----------XXXX--XX----------XXXXX-----X----------------------------------------XXXX-XXX
-----XXXXX-XXXX------XX-XXXXXX---------------------------------------------------------------------------------------XXXX----E----XXXXX--XX---------XXXXXXE----X---------------------------------------XXXXX-XXX
XXXXXXXXXX-XXXXXXXXXXXXXXXXXXXXXXXXXXXXXXXX--XXXXXXXXXXXXXXXXXXXXXXXXXXXXXXXXXXXXXXXXXXXXXXXXXXXXXXXXXXXXXXXXXX--XXXXXXXXXXXXXXXXXXXXXX--XXXXXXXXXXXXXXXXXXXXXXXXX-----X---XXXXX-XXXXXXXXXX---XXX----XXXXXXX-XXX