----------------------------------------------------------------------------------------------------------------------------------------------------------------------------------------------------------------
----------------------------------------------------------------------------------------------------------------------------------------------------------------------------------------------------------------
----------------------------------------------------------------------------------------------------------------------------------------------------------------------------------------------------------------
----------------------------------------------------------------------------------------------------------------------------------------------------------------------------------------------------------------
----------------------------------------------------------------------------------------------------------------------------------------------------------------------------------------------------------------
----------------------------------------------------------------------------------------------------------------------------------------------------------------------------------------------------------------
----------------------------------------------------------------------------------------------------------------------------------------------------------------------------------------------------------------
---------------------------------------------------------------------------XX-------------------------------------------------XXX-------------------------------------------------------------------------------
---------------------------------------------------------------------------XX-------------------------------------------------XXX-------------------------------------------------------------------------------
---------------------------------------------------------------------------XX-------------------------------------------------XXX-------------------------------------------------------------------------------
----------------------------------------------------------Q-------------X--XX------------------------------SQ--------------X--XXX-------------------------------------------------------------------------------
-----------------------------------------------------------------------XX--XX----------------------XX--X-------------------X--XXX-------SS--S-------------S-----------------------------------------------------
----------------------------------------------------------------------XXX--XX---------------------XXX--X------------------XX--XXX-------------------------------------------------------------------------------
---------------------------------------------------------------------X-XX--XX--------------------XXXX--X-----------------XXX--XXX-------------------------------------------------------------------------------
------------------------E-------------------------------------------XXXXX--XX-------------------XXXXX--X---SSSSS--------XXXX--XXX-------------------------------------------------------------------------------
X----X--XXXXXXXXXXXXXXXXXXXXXXXXXXXXX-X-X--XXXXXXXXXXXXXXXXXXXXXXXXXXXXXX--XXXXXXXXXXX-X-XXXXXXXXXXXX--X-------XXXXXXXXXXXXX--XXXXXXXXXXXXXXXXXXXXXXXXXXXXXXXXXXXXXXXXXX-X-X----------X-XXXXXXXXXX--XXX--XXXXXXX