----------------------------------------------------------------------------------------------------------------------------------------------------------------------------------------------------------------
----------------------------------------------------------------------------------------------------------------------------------------------------------------------------------------------------------------
----------------------------------------------------------------------------------------------------------------------------------------------------------------------------------------------------------------
---------------------------------------------------------------------------------------------------------SSSSSSSSSSSSSSSSSSSSS----------------------------------------------------------------------------------
----------------------------------------------------------------------------------------------------------------------------------------------------------------------------------------------------------------
---------------------------------------------------------------------------------------------------------------------------------------------------------------------oooooooooo--E------------------------------
---------------------------------------------------------------------------------------------------------------------------------------X-------------------------SSSSSSSSSSSSSSSSS---SSSSSSSSS------------------
-------------------------------------------------------------------------------XX-----------------------------------------------------XX----------------------------------------------------------SSSSSSSS------
-----------------------------------------------------------------------------E-XX----------------------------------------------------XXX------------------------------------------------------------------------
-----------------------------------------------------------------------------XXXX------------------------------------XXXXX----------XXXX-----------------------------------------------------------E------------
-------------------------------------------------------------------XX-------XXXXX----------------------------------XXXXXXX---------XXXXX---------------------------SSSSSSSSSSSSSS--X---------SSSSSSS------------
------------------------------------------------------------------XXX------XXXXXX---------------------------------XXXXXXXX--------XXXXXX-------------------------------------------X----------------------------
-----------------------------------------------------------------XXXX-----XXXXXXX------------------------oooo----XXXXXXXXX-------XXXXXXX-----------------------------------------XXX----------------------------
----------------------------------------------------------------XXXXX----XXXXXXXX-------------------------------XXXXXXXXXX------XXXXXXXX-----------------------------------EE---XXXXX---------------------------
XX-------------------------------------------------------------XXXXXXXXXXXXXXXXXXXXXXXXXXXXXXXXX-------XXXXXXX-XXXXXXXXXXX--XXXXXXXXXXXXXXXXX--------X----------XXXXXXXXXXXXXXXXXXXXXXXXXXXXXXXXXXXXX-------S--S
XX-------------------------------------------------------------XXXXXXXXXXXXXXXXXXXXXXXXXXXXXXXXX----X--XXXXXXXXXXXXXXXXXXX--XXXXXXXXXXXXXXXXX--------X----------XXXXXXXXXXXXXXXXXXXXXXXXXXXXXXXXXXXXX-----------