----------------------------------------------------------------------------------------------------------------------------------------------------------------------------------------------------------------
----------------------------------------------------------------------------------------------------------------------------------------------------------------------------------------------------------------
----------------------------------------------------------------------------------------------------------------------------------------------------------------------------------------------------------------
----------------------------------------------------------------------------------------------------------------------------------------------------------------------------------------------------------------
----------------------------------------------------------------------------------------------------------------------------------------------------------------------------------------------------------------
----------------------------------------------------------------------------------------------------------------------------------------------------------------------------------------------------------------
--------------------------------------------------E-------------------------------------------------------------------------------------------------------------------------------------------------------------
--------XX---------------------------------------SSSSSSSSS--------------------------------------------------------------------XX-----------------------------------------SSSSSSSS-------------------------------
-------XXX--------------------------------------------------------------------------------------------------------------------XX--------------------------------------------------------------------------------
------XXXX---------------------------------------------------------X----------------------------------------------------------XX--------------------------------------------------------------------------------
-----XXXXX--------------------------------------------------------XX-------------------------------------------------------X--XX--------------------------------------------------------------------------------
----XXXXXX----------------XX--X----------------------------------XXX------------------------------------------------------XX--XX--------------E-----------------X--X------SSSSSSS-------------------------------
---XXXXXXX---------------XXX--XX-------------E-E----------------XXXX----------------------------------------------E--E---XXX--XX-------------<>---------------EXX--XX-------------------------------------------
--XXXXXXXX--------------XXXX--XXX------------------------------XXXXX----------------------------------------------------XXXX--XX-------------[]---------------XXX--XXXX-----------------------------------------
-XXXXXXXXX-------------XXXXX--XXX-----------------------------XXXXXX------------EEE------------------------------------XXXXX--XX-------------[]--------------XXXX--XX-X-----------------------------------------
XXXXXXXXXXXXXXXXXXX--XXXXXXX--XXXXXXXXXXXXXXXXXXXXXXXX-----XXXXXXXXXXXXXXXXXXXXXXXXXXXXXXXXXXXXXXXXXX-X--XXXXXXXXXXXXXXXXXXX--XXXXXXXXXXXXXXXXXXXXXXXXXXXXXXXXXXX--X--XXXXXXXXXXXXXXXXXXXXXXXXX-X--XXX-------XXX