----------------------------------------------------------------------------------------------------------------------------------------------------------------------------------------------------------------
----------------------------------------------------------------------------------------------------------------------------------------------------------------------------------------------------------------
----------------------------------------------------------------------------------------------------------------------------------------------------------------------------------------------------------------
----------------------------------------------------------------------------------------------------------------------------------------------------------------------------------------------------------------
-----------------------------------------------------------------------------------SSSSSSSSSSSSSSSSSSSSSSSSSS---------------------------------------------------------------------------------------------------
----------------------------------------------------------------------------------------------------------------------------------------------------------------------------------------------------------------
----------------------------------------------------------------------------------------------------------------------------------------------------------------------------------------------------------------
-------XX------------------------------------------XX------------------------------------------------------------------------------XX---------------------------------------------------------------------------
---E---XX-------------------------------------E---XXX-------------------------------------------------------------------------E---XXX---------------------------------------------------------------------------
-------XX-----------------------------------------XXX-----------------------------------------------------------------------------XXX---------------------------------XX----------X-----------------------------
-----X-XX---------------------------------------X-XXX---------------------------------------------------------------------------X-XXX--------------------------------XXX---------XX-----------------------------
----XX-XX----------XX--X-----------------------XX-XXX----QQQQQ-QQQQ-----------------------------X------------------------------XX-XXX---QQQ------------------------X-XXX--------XXX-----------------------------
--X-XX-XXX--------XXX--XX----------------------XX-XXX------------------------------------------XX---X--------------------------XX-XXX-----------------------------XX-XXX------EXXXX-----------------------------
-XX-XX-XXX-------XXXX--XXX------------------XX-XX-XXX-----------------------------------------XXX---XX-----------------------X-XX-XXX----------------------------XXX-XXX------XXXXX-----------------------------
-XX-XX-XXX------XXXXX--XXXX----------------XXX-XX-XXX--------------------------------------E--XXX-E-XXX---------------------XX-XX-XXX---------------------------XXXX-XXX-----XXXXXXE----------------------------
XXX-XX-XXXXXXXXXXXXXX--XXXXXXXXXXXXXXXXXXXXXXX-XX-XXXXXXXXXXXXXXXXXXXXXXXX--XXXXXXXXXXXXXXXXXXXXXXXXXXXXXXXXXXXX-XXXXXXXXXXXXX-XX-XXXXXXXXXXXXXXXXXXXXXXX-X-XXXXXXXX-XXXXXXXXXXXXXXXXXXXXXXXXXXXX--X-X-XXXXXXXXX