----------------------------------------------------------------------------------------------------------------------------------------------------------------------------------------------------------------
----------------------------------------------------------------------------------------------------------------------------------------------------------------------------------------------------------------
----------------------------------------------------------------------------------------------------------------------------------------------------------------------------------------------------------------
----------------------------------------------------------------------------------------------------------------------------------------------------------------------------------------------------------------
----------------------------------------------------------------------------------------------------------------------------------------------------------------------------------------------------------------
----------------------------------------------------------------------------------------------------------------------------------------------------------------------------------------------------------------
----------------------------------------------------------------------------------------------------------------------------------------------------------------------------------------------------------------
-----------------------------------------------------------------------------------------XX-------------------------------------------XX------------------------------------------------------------------------
----------------------X-------------------------------------------------------------E---XXX-------------------------------------------XX------------------------------------------------------------------------
---------------------XX-----------------------------------------------------------------XXX-----------------------------------------X-XX------------------------------------------------------------------------
------------------X--XX---------------------------------------------------------------X-XXX------------------------XX---------------X-XX------------------------------------------------------------------------
------------------X--XX--------------------------------------------------------------XX-XXX-----------------------XXX--X----------X-X-XX-----QQQ----------------------------------------------------------------
------------------X--XX-------------------------------------------E------------------XX-XXX----------------------XXXX--XX---------X-X-XX------------------------------------------------------------------------
------------------X--XX------------------------------------------------------------X-XX-XXX---------------------XXXXX--XXX------X-X-X-XX---------------------------XXXXXXXX-------------------------------------
------------------X--XX----XXXXXXX------------------------------------------------XX-XX-XXX--------------------XXXXXX--XXX-----XX-X-X-XX------------------XXXX-----X------X----------------------------X--------
----------XXXXXXXXXXXXX---------------------------X-XXXXXXXXXXXXXXXXXXXXXXXX--XXX-XX-XX-XXXXXXXXXXXXX---XXXXXXXXXXXXXXXXXXXXXXXXX-X-X-XXXXXXXXXXXX-----------------X------X----------XXXXXXXXXXXXXXXXXXXXXXXXXXX