----------------------------------------------------------------------------------------------------------------------------------------------------------------------------------------------------------------
----------------------------------------------------------------------------------------------------------------------------------------------------------------------------------------------------------------
----------------------------------------------------------------------------------------------------------------------------------------------------------------------------------------------------------------
----------------------------------------------------------------------------------------------------------------------------------------------------------------------------------------------------------------
----------------------------------------------------------------------------------------------------------------------------------------------------------------------------------------------------------------
----------------------------------------------------------------------------------------------------------------------------------------------------------------------------------------------------------------
----------------------------------------------------------XX---------SSSSSSSSSS--------------SSSSSSSSSSSSS---SSSSS------------------XX--------XXXX---------------------------------------SSSSSSSSSSS------------
----------------------------X----------------------------XXX----------------------------------------------E-------------------------XX--------XXXX--------------------------------------------------------------
--------------------------------------------------------XXXX-----------------------------------------------------------------------XXX--------XXXX--------------------------------------------------------------
-------------------------------------------------------XXXXX--------------------------------------E-------------------------------XXXX--------XXXX-----------------------------------------------------------B-X
------------------------------------------------------XXXXXX----------SSSSSSSSSS------XX-----SSSSSSSSSSSS--X---------------------XXXXX--------XXXX------------------------------------------SSSSSSS---------XXXX
-----------------------------------------------------XXXXXXX--------------------------XXX-----------------XX--------------------XXXXXX--------XXXX---------------------------------------------------------XXXXX
----------------------------------------------------XXXXXXXX-------------------------XXXX----------------XXX-------------------XXXXXXX--------XXXX--------------------------------------------------------XXXXXX
---------------------------------------------------XXXXXXXXX------------------E-----XXXXX-----------E---XXXX------------------XXXXXXXX--------XXXX-----------------------------------------------E-------XXXXXXX
-------------------------------XXXXXXXXXXXXXXXXXXXXXXXXXXXXXXXXXXXXXXXXXXXXXXXXXXXXXXXXXXXXXXXXXXXXXXXXXXXXXXXXXXXXXXXXXXX----XXXXXXXX-X------XXXX--------XXXXXXX-----------------XXXXXXXXXXXXXXXXXX-XXXXXXXXXXX
-------------------------------XXXXXXXXXXXXXXXXXXXXXXXXXXXXXXXXXXXXXXXXXXXXXXXXXXXXXXXXXXXXXXXXXXXXXXXXXXXXXXXXXXXXXXXXXXX----XXXXXXXX-X------XXXX--------XXXXXXX-----------------XXXXXXXXXXXXXXXXXX-XXXXXXXXXXX