----------------------------------------------------------------------------------------------------------------------------------------------------------------------------------------------------------------
----------------------------------------------------------------------------------------------------------------------------------------------------------------------------------------------------------------
----------------------------------------------------------------------------------------------------------------------------------------------------------------------------------------------------------------
----------------------------------------------------------------------------------------------------------------------------------------------------------------------------------------------------------------
----------------------------------------------------------------------------------------------------------------------------------------------------------------------------------------------------------------
------------------------------------------------------------------------------------------------------------------------------------------------------------E--E------------------------------------------------
------------------------------------------------------------------------------------------SSSSSSSSS---------E----------------------------------SSSSSS-----SSSSSSSSS---------------------------------------XX----
----------------------------------------------------------------------------------------------------------------------------------------------------------------------------------------------------------XX----
--------------------------------------------------------------------------------------------------------------------------------------------------------------------------------------------------------XXXX----
-------------------------------------------------------------------------------------------------------------------------------------------B--E---------------------------------------------------------XXXX----
------------------XX-----------------------------------------------------------------------SSSSSSSS---------------------------------------XXXXXSSSSSS---------------------------------------------------XXXX----
------------------XX----------------E---------X------------------------------------------------------------------------------------------XXXXXX-------------E-----------------------------------------X-XXXX----
------------------XX--------------------------XX----------------------------------------------------------------------------------------XXXXXXX-------------------------------------------------------X-XXXX----
------------------XXXX------------------------XXX-----------------------------------------------------------------------E--------------XXXXXXXX--------E----------------------------------------------X-XXXX----
XXXXXXX-X---------XXXXXXXXXXXXXXXXXXXXXXXX----XX----XXXXXXX---XXXXXXXXXXX----------------XXXXXXXXXX-----X-----XXXXXXXXXXXXXXX----------XXXXXXXXXXXXXXXXXXXXXXXXXXXXX----X------XXXXXXXXXXXXXX---------X-XXXXXXXX
XXXXXXX-X---------XXXXXXXXXXXXXXXXXXXXXXXX----XX----XXXXXXX---XXXXXXXXXXX----------------XXXXXXXXXX-----X-----XXXXXXXXXXXXXXX----------XXXXXXXXXXXXXXXXXXXXXXXXXXXXX----X------XXXXXXXXXXXXXX---------X-XXXXXXXX