----------------------------------------------------------------------------------------------------------------------------------------------------------------------------------------------------------------
----------------------------------------------------------------------------------------------------------------------------------------------------------------------------------------------------------------
----------------------------------------------------------------------------------------------------------------------------------------------------------------------------------------------------------------
-----------------------------------------------------------------------------------------------------------------------------------------------------------------------------------SSSSSSSSSSSSS----------------
------------------------------------------------------------------------------------------------------------------------------------SSSSSS---SSSSSSSSSSSSSSSSSSSSSSSSSSSS---------------------------------------
----------------------------------------------------------------------------------------------------------------------------------------------------------------------------------------------------------------
-----------------------------SSSSSSSS---------------------------------------------------------------------------------------------------------------------------------------------------------------------------
------------------------------------------------XX---------------------------------------------SSS---S----------------------------------------------------------------------------------------------------------
-----------------------------------------------XXX-SS-----------------------------------------------------------------------------------------------------------------------------------------------------------
---------------------------------------X-------XXX---------------------------------X----------------------------------------------------------------------------------------------------------------------------
------------------------------SSSSSS--XX-----X-XXX--------------------------------XXS--SQ-----------------------------------SSSSSS------------------------------------------------------------------------------
----------------XX-------------------XXX----XX-XXX-------------------------------XXX-----------SSS---SSS---------------------------------------------QQQQ----------------X--X----------------------------------S
---------------XXX------------------XXXX----XX-XXX--SSS-------------------------XXXX--------------------------------X-XXX-------------------------------------------X-X--X--X-----------------------------------
--------------XXXX-----------------XXXXX----XX-XXX-----------------------------XXXXX-------------------------------XXXX-------------------------------------------EXX-X--X--XX-----------X-X--------------------
-------------XXXXX----------------XXXXXX----XX-XXX----------------------------XXXXXX---SSSS----------------------XXXX-------------------------------------------E-XXX-X--X--XX---------XXXXX--------------------
XXXXXXXX--XXXXXXXX---XXXXXXXXXXXXXXXXXXX-XX-XX-XXXXXX---XXXXXXXXXXXXXXXXXXXXXXXXXXXX------X--XXXXXXXXXXXXXXXXXXXXXXXX------XXXXXXXXXXXXX-XX----XXXXXXXXXX----XXXXXXXX-X--X-XXX-X--XXXXXXXXXX--X--X---XXXXXXXXXXX