----------------------------------------------------------------------------------------------------------------------------------------------------------------------------------------------------------------
----------------------------------------------------------------------------------------------------------------------------------------------------------------------------------------------------------------
----------------------------------------------------------------------------------------------------------------------------------------------------------------------------------------------------------------
----------------------------------------------------------------------------------------------------------------------------------------------------------------------------------------------------------------
------------------------------------------------------------------------------------------------------------------------SSSSSSSSSSSSSSSSSSSSSSSSS---------------------------------------------------------------
----------------------------------------------------------------------------------------------------------------------------------------------------------------------------------------------------------------
----------------------------------SSSSSSSS----------------------------------------------------------------------------------------------------------------------------------------------------------------------
------------------XX--------------------------------------------------------------------------------XX----------------------------------------------------------------------------------------------------------
----------------XXXX---------------------------------------------------------------------------E---XXX----------------------------------------------------------------------------------------------------------
-----X---------XXXXX-------------------------------------------------------------------------------XXX----------------------------------------------------------------------------------------------------------
----XXX-------XXXXXX---------------SSSSSSSSSS------------------------------XSS-SQ----------------X-XXX-------------X--------------------------------------------------------------------------------------------
---XXXX------XXXXXXX---QQQQ------------------------------------XX---------XX--------------------XX-XXX--------X-X-XX------------X-X---------------------------XX--------------------------X--X------------------
-EXXXXX-----XXXXXXXX------------------------------------------XXX--------XXX--------------------XX-XXX-------XX-X-XXX---------X-X-X-X-X---------------------XXXX-------------------------XX--XX-----------------
-XXXXXX----XXXXXXXXX---------XX-------------------------------XXXX------XXXX------------------X-XX-XXX------XXX-X-XXX---------X-X-X-X-X--------------------XXXXXX-----------------------XXX--XXX----------------
XXXXXXX---XXXXXXXXXX---------XX-------------------------------XXXX-----XXXXX---SSSSS---------XX-XX-XXX-----XXXX---XXXX------X-X-X-X-X-X-X-----------------XXXXXXX---------------------XXXXX--XXX----------------
XXXXXXXXXXXXXXXXXXXXXXXXXXXXXXXXXXXXXXXXXXXXXXXXX-XXX-X-XXX-XXXXXXX-XXXXXXXX------XXXXXXXXXXXXX-XX-XXXXXXXXXXXXXXXXXXXXXXXXXXXXXXXXXXXXXXXXXXXXXX-X--XXXXXXXXXXXXXXXXXXXXXXXXXXXXXXXXXXXXXX--XXXXXXXXXXXXXXXXXXX