----------------------------------------------------------------------------------------------------------------------------------------------------------------------------------------------------------------
----------------------------------------------------------------------------------------------------------------------------------------------------------------------------------------------------------------
----------------------------------------------------------------------------------------------------------------------------------------------------------------------------------------------------------------
----------------------------------------------------------------------------------------------------------------------------------------------------------------------------------------------------------------
----------------------------------------------------------------------------------------------------------------------------------------------------------------------------------------------------------------
---------------------------------------------------------------------------------------------------------------------------------------------------------------------------------E------------------------------
---------------------------------------------SSSSSSSSS------------------------------X---------SSSSSSSSSSSSSSSS-----------------------------------------------------XX--------SSSSSSSSSSSS-----------------------
-----------------------------------------------------------------------------------XX-------------------------------------------------------------------E---------XXX-------------------------------------------
---------------------------------------------------------------------------------EXXX--------------------------------------------B-------------------------------XXXX-------------------------------------------
---------------------------------------------------E------------------XX---------XXXX--------------------------------------------b------------------------------XXXXX--------------E----------------------------
--------XXX-----------------------------------SSSSSSSSS-------------------------XXXXX-------------------SSSSSSS---X-------------XXX----------------------------XXXXXX---------SSSSSSSSSSSS-----------XX---------
-------XXXX--------------------------------------------------------------------XXXXXX-----------------------------XX-----------XXXX---------------------------XXXXXXX-------------------------------XXX---------
------XXXXX-------------------------------------------------------------------XXXXXXX-----------------------------XXX---------XXXXX--------------------------XXXXXXXX------------------------------XXXX---------
-----XXXXXX---------------------------------------------------------X--------XXXXXXXX--------------------E---E----XXXX-------XXXXXX-------------------------XXXXXXXXX-----------------------------XXXXX---------
XXXXXXXXXXXXXXXXXXXXXXXXXXXXXXXXXXXXXXXXXXXXXXXXXXXXXXXXXXXXXXXXXXXXX-------XXXXXXXXXXXXX----XXXX----XXXXXXXXXXX--XXXX-------XXXXXXXXXXXXXXXXXXXXXXXXXXXXXXXXXXXXXXXXXX-----XXXXXXXXXXXXXXX---XXXXXXXXXXXXXXXXXX
XXXXXXXXXXXXXXXXXXXXXXXXXXXXXXXXXXXXXXXXXXXXXXXXXXXXXXXXXXXXXXXXXXXXX-----X-XXXXXXXXXXXXX----XXXX----XXXXXXXXXXX--XXXX-------XXXXXXXXXXXXXXXXXXXXXXXXXXXXXXXXXXXXXXXXXX-----XXXXXXXXXXXXXXX---XXXXXXXXXXXXXXXXXX