----------------------------------------------------------------------------------------------------------------------------------------------------------------------------------------------------------------
----------------------------------------------------------------------------------------------------------------------------------------------------------------------------------------------------------------
----------------------------------------------------------------------------------------------------------------------------------------------------------------------------------------------------------------
----------------------------------------------------------------------------------------------------------------------------------------------------------------------------------------------------------------
--------------------------------------SSSSSSSSSSSSSSSSSS--------------------------------------------------------------------------------------------------------------------------------------------------------
----------------------------------------------------------------------------------------------------------------------------------------------------------------------------------------------------------------
----------------------------------------------------------------------------------------------------------------------------------------------------------------------------------------------------------------
---------------------------------XXX-------------------------------------XX----------------------------------------XX-------------------------------------------------------------------------------------------
--------------------------------XXXX------------------------------------XXX---------------------------------------XXX------------------------------------------------------------------------------------------E
-------------------------------XXXXX-----------------------------------XXXX---------------------------------------XXX------------------------------------------------------------------------------------------X
------------------------------XXXXXX--------------------SSSS----------XXXXX-------------------------------------X-XXX-----------------------------------------------------------------------------------------XX
-----------------------------XXXXXXX---------------------------------XXXXXX---SQQ------------------------------XX-XXX----------------------------------------------------X-X---------------------------------XXX
-------XXX------------------XXXXXXXX---------------------------------XXXXXX------------------------------------XX-XXX----------E----------E-----E-----------------------XX---------------------------------EXXXX
----XX-X-------------------XXXXXXXX---------X----------------------X-XXXXXX----------------------------------X-XX-XXX---------<>---------------------------------------XXX---------------------------------XXXXX
XXXXXX--------------------XXXXXXXXX---------X---------------------XX-XXXXXX---------------------------------XX-XX-XXX---------[]-------------------------------------XXXXX--------------------------------XXXXXX
XXXXXX-----XX--XXXXXXXXXXXXXXXXXXXXXXXXXXXXXX--XXXX-----XXXXXXXXXXXX-XXXXXXXXXXXXXXXXXXXXXXXXXXXXX--XXX-XXXXXX-XX-XXXXXXXXXXXXXXXXXX-XXXXXXXXXXXXXXXX---XXXXXXXXXXXXXXXXXXXXXXXXXXXXXXXXXXXXXXX-XXXX----XXXXXXXX