----------------------------------------------------------------------------------------------------------------------------------------------------------------------------------------------------------------
----------------------------------------------------------------------------------------------------------------------------------------------------------------------------------------------------------------
----------------------------------------------------------------------------------------------------------------------------------------------------------------------------------------------------------------
----------------------------------------------------------------------------------------------------------------------------------------------------------------------------------------------------------------
--------------------------------------------SSSSSSSSSSSSSSSSSSSSSSSSSSS------------------------------E----------------------------------------------------------------------------------------------------------
----------------------------------------------------------------------------------------------------------------------------------------------------------------------------------------------------------------
----------------------------------------------------------------------------------------------------------------------------------------------------------------------------------------------------------------
-----------------------------XX-----------------------------------------------------------------------XX-----------------------------------------------------------------------XX-------------------------------
----------------------------XXX-----------------------------------------------------------------------XX-----------------------------------------------------------------------XX-------------------------------
---------------------------XXXX--------------------------------------------------------X------------X-XX-----------------------------------------------------------------------XX-------------------------------
--------------------------XXXXX---------------------------------------XX--------------XX------------X-XX--------------------------------------------------------------------X--XX-------------------------------
-----------------E-------XXXXXX---SQQQ---------E---------------------XXX-------------XXX----------X-X-XX--------------------------------------------------------------------X--XX-------------------------------
----------------<>------XXXXXXX---------------<>-------------------EXXXX-------------XXX----------X-X-XX----------------------------------X---------------------------------X--XX-------------------------------
----------------[]-----XXXXXXXX---------------[]-------------------XXXXX-----------X-XXX--------X-X-X-XX-----------------X---------------XX--XXX----XXXXXXX---XX---------X--X--XX-------------------------------
----------------[]----XXXXXXXXX---------E-----[]------E----E------XXXXXX----E-----XX-XXX--------X-X-X-XX-----------------X--------------XXX---------X---------X----------X--X--XX-------------------------------
--XXXXXXXXXXXXXXXXXXXXXXXX-XXXXXXXXXXXXXXXXXXXXXXXXXXXXXXXXXXXXXXXXXXXXXXXXXXXXXXXXXXXXX--XXXXXXX-X-X-XXXXXXXXXXXXXXXXXXXXXXXXXXXXXXXXXXXXX---------X---------X--XXXXXXXXXX-X--XXXXXXXXXXXXXXXXXXX-XX-XXXXXXXXXX