----------------------------------------------------------------------------------------------------------------------------------------------------------------------------------------------------------------
----------------------------------------------------------------------------------------------------------------------------------------------------------------------------------------------------------------
----------------------------------------------------------------------------------------------------------------------------------------------------------------------------------------------------------------
----------------------------------------------------------------------------------------------------------------------------------------------------------------------------------------------------------------
-----------------------------------------------------------------------------------------------------------------------------------------------------------------------E----------------------------------------
----------------------------------------------------------------------------------------------------------------------------------------------------------------------------------------------------------------
----------------------------------------------------------------------------------------------------------------------------------------------------------------------------------------------------------------
---------------------------------------------------X--------------------------------------------------------------------------------------------------------------------XX------------------E-------------------
---------------------------------------------------X---------------------------------------------------------------------------------------------------------------E---XXX------------------X-------------------
---------------------------------------------------XX-----------------------------------------------------------------------------------------------------------------XXXX---------------E--X-------------------
------------------------XXXXXXXX----------------X--XX-X--------------------------------------------------------------------------------------X------------------------XXXX------------X--X--X-------------------
-----------------------------------------------XX--XX-X-----------------XXXXXXXXXXXXXXXXX-------------------------------------------------E--X----------------------X-XXXX---------E--X--X--X-------------------
----------------------------------------------XXX--XXXX----------------XX-----------------------------------------------------------------X--X----------------------X-XXXX---------X--X--X--X-------------------
---E----------------X------------------------XXXX--XXXX---------------XXX--------------------------------------------------------------X--X--X--X-----------------X-X-XXXX---------X--X--X--X-------------------
XXXXXXXXXXXXXXXXXXXXX-----------------------XXXXX--XXXX-----XXXXXXXXXXXXX---------------------------------XXXXXXXXXXXXXXXXXXXXXXXXXXXXXX--X--X--X-----------------X-X-XXXX---------X--X--X--X---XXXXXXXXXXXXXXXX
XXXXXXXXXXXXXXXXXXXXX----------------------XXXXXX--XXXX-----XXXXXXXXXXXXX-------------------XXXXXXXXXX---XXXXXXXXXXXXXXXXXXXXXXXXXXXXXXX--X--X--XXXXXXXXXXXXXXXXX-X-X-XXXX-XXXXXXX-X--X--X--X---XXXXXXXXXXXXXXXX