----------------------------------------------------------------------------------------------------------------------------------------------------------------------------------------------------------------
----------------------------------------------------------------------------------------------------------------------------------------------------------------------------------------------------------------
----------------------------------------------------------------------------------------------------------------------------------------------------------------------------------------------------------------
---------------------------------------------------------------------------------------------------------------------------------------SSSSSSSSSSSSSSS----------------------------------------------------------
----------------------------------------------------------------------------------------------------------------------------------------------------------------------------------------------------------------
----------------------------------------------------------------------------------------------------------------------------------------------------------------------------------------------------------------
-------------------------------------------------------------XX--------------------------------------------XX--------------X------------------------------------------------------------------------------------
------------------------------------------------------------XXX----XX---------------E---------------------XXX-------------XX------------------------------------------------------------------------------------
-----------------------------------------------------------XXXX------------------------------------------XXXX------------XXX------------------------------------------------------------------------------------
-------------------------------------------------E--------XXXXX------------------------oooo-------------XXXXX-----------XXXX-------------------XXXX------------------------------ooo----------------------------
------------------------------------------------<>-------XXXXXX-----------------------XXXXXX-----------XXXXXX---------XXXXXX------------------XXXXX-------------------------------------------------------------
------------------------------------------------[]------XXXXXXX---------------------------------------XXXXXXX---------XXXXXX------------------XXXXXX-------------------XXXX-------------------------------------
------------------------------------------------[]-----XXXXXXXX-E------------------------------------XXXXXXXX---------XXXXXX------------------XXXXXX------------------XX----------------------------------------
------------------------------------------------[]----XXXXXXXXX<>-----------------------------------XXXXXXXXX---------XXXXXX------------------XXXXXX-----------------XXX------XXXXXXXXXXXX----------------------
--------------------------------------------XXXXXXXX-XXXXXXXXXX[]---------------------------XXXXXXXXXXXXXXXXXXXXXXXXXXXXXXXXXXXXXX----XXXXXXXXXXXXXXXXXXXXXXXXXXXXXXXXXX------X---------------------------------
--------------------------------------------XXXXXXXX-XXXXXXXXXX[]---------------------------XXXXXXXXXXXXXXXXXXXXXXXXXXXXXXXXXXXXXX----XXXXXXXXXXXXXXXXXXXXXXXXXXXXXXXXXX------X---------------------------------