----------------------------------------------------------------------------------------------------------------------------------------------------------------------------------------------------------------
----------------------------------------------------------------------------------------------------------------------------------------------------------------------------------------------------------------
----------------------------------------------------------------------------------------------------------------------------------------------------------------------------------------------------------------
----------------------------------------------------------------------------------------------------------------------------------------------------------------------------------------------------------------
----------------------------------------------------------------------------------------------------------------------------------------------------------------------------------------------------------------
----------------------------------------------------------------------------------------------------------------------------------------------------------------------------------------------------------------
------------------------------------------------------------------------------------XX-------------------------------------------------------------------SSSSSSSSS----------XX----------------------------------
------------------------XX---------------------------------XX----------------------XXX---------------------X---------------------------------------------------------------XXX----------------------------------
----------------------------------------------------------------------------------XXXX------------------------------------------------------------------------------------XXXX----------------------------------
---------------------------------------------------------------------------------XXXXX-------------------------------------------------------------------------E----------XXXX----------------------------------
----------------------------------------------------------------------XX--------XXXXXX--------------------------------------------------------------------SSSSSSSS--------XXXX---XXXXXXX------------------------
-----------------------------------------XX--XXX----------------------XX-------XXXXXXX----------------------------------------------------------------------------------X-XXXX----------------------------------
----------------------------------------XXX-E-------------------------XX------XXXXXXXX----------------------------------------------------------------------------------X-XXXX----------------------------------
---------------------------------------XXXX------------------------X--XX-----XXXXXXXXX---------------------------------------------------------EE-------------E---------X-XXXX----------------------------------
---XXXXXXX-------------------------XXXXXXXX------------------------X--XXXXX-XXXXXXXXXX-------XXX---------------XXXXXXXX----------XXXXXXXXXXXXXXXXXXXXXXXXXXXXXXXXXXXXX--X-XXXX-------------------------------XXX
---XXXXXXX----X--------------------XXXXXXXX------------------------X--XXXXXXXXXXXXXXXX-------XXX---------------XXXXXXXX----------XXXXXXXXXXXXXXXXXXXXXXXXXXXXXXXXXXXXX--X-XXXX-------------------------------XXX