----------------------------------------------------------------------------------------------------------------------------------------------------------------------------------------------------------------
----------------------------------------------------------------------------------------------------------------------------------------------------------------------------------------------------------------
----------------------------------------------------------------------------------------------------------------------------------------------------------------------------------------------------------------
----------------------------------------------------------------------------------------------------------------------------------------------------------------------------------------------------------------
---------------------------------------------------------------------------------------------------------SSSSSSSSSSSSSSSSSSSSSSSSSSSSSSSSSSSSSSSSS--------------------------------------------------------------
----------------------------------------------------------------------------------------------------------------------------------------------------------------------------------------------------------------
----------------------------------------------------------------------------------------------------------------------------------------------------XX----------------------------------------------------------
-----XXX---------------------------------------------------------------------------------------------------oooooo-----------------------------------------------------------------------------------------------
---------------------------------------------------------------------------------------------------------------------------------------------------------------------------------XXXX---------------------------
oooooo-----------------------------------------ooo---------ooooo--------------------------------------------SSSS--------------------------------------------------------------------------------------------X-X-
XXXXXX----------------------------------------------------------------------------------------------------SSSSSS--------------E----------------------------------------------------------XXXX--------------XX---
------------------------------------------------------------------XXX--------------------------------------------------------<>------------------X---------------------------------------------------------XX---
--------------------------------------------------------------------------------------------------------------------------X--[]--XX-------------XX--XX---------------------------------------------------X-XX---
---------------------------------------------XXXXXXXXXX--XXXXXXXXX--------------------X----------------------------------XX--[]--XX------------XXX------------------------------------------------------XX-XX---
-------XXXXXXXXX-----------------------------X--------X--X-------X----------------------------XXXXXXX----------------E---XX--[]--XX-----------XXXX-----------------------------------------------------XXX-XX---
-----------------------------X---------------X--------X--X-------X---------------------------------------XXXXXXXXXXXXXXXXXXXXXXXXXX--XXXXXXXXXXXXX------XXXXXXXXXXXXXXXXXXXX-X-----------------X-XXXXXXXXXXXX---