----------------------------------------------------------------------------------------------------------------------------------------------------------------------------------------------------------------
----------------------------------------------------------------------------------------------------------------------------------------------------------------------------------------------------------------
----------------------------------------------------------------------------------------------------------------------------------------------------------------------------------------------------------------
----------------------------------------------------------------------------------------------------------------------------------------------------------------------------------------------------------------
------------------------------------------------------------------------E---------------------------------------------------------------------------------------------------------------------------------------
----------------------------------------------------------------------------------------------------------------------------------------------------------------------------------------------------------------
-----------------------------------------------------------------------------------------------------------------------------------o----------------------------------------------------------------------------
--------------------------------------XX---------------------------------XX--------------------------------------------------------------------------------------------XX-----------------------------------XX--
-------------------------------------XXX---------------------------------XX-------------------------------------------------------------------------------------------XXX-----------------------------------XX--
-----------------------------------EXXXX-------------------------------XXXX---------------------------------------------------X--------------------------------------XXXX--------------------------------X--XX--
-----------------------------------XXXXX-------------------------------XXXX--------------------------------------------------XX-----------E-E-----------------------XXXXX-------------------------------XX--XX--
---------XX-------X-XX------------XXXXXX-----------------------------X-XXXX---SQQ------------S------XX----------------------XXX------XXXXXXXX---------------------XXXXXXX------------------------------XXX--XX--
---------XX-------X-XXX----------XXXXXXX------------------------E---XX-XXXX-------------------------XX---------------------XXXX-----X----------------------------XXXXXXXX-----------------------------XXXX--XX--
---------XX-----X-X-XXXX--------XXXXXXXX---------------------------XXX-XXXX------------------------XXX--------------------XXXXX----XX---------------------------XXXXXXXXX----------------------------XXXXX------
------E--XX-----X-X-XXXX-------XXXXXXXXX--------------------------XXXX-XXXX----------X---------E--XXXX-------------------XXXXXX---XXX--------------------------XXXXXXXXXX--------X-----E------------XXXXXX------
XXXXXXXXXXXXXXXXXXXXXXXXXX--XXXXXXXXXXXXXXXXXXXXX-XXXXXXXXXXXXXXXXXXXX-XXXXXXXXXXXXXXXXXXXXXXXXXXXXXXXXXXXXXXXXXXX---XXXXXXXXXXXXXXXX---------X--XXXXXXXXXX--XXXXXXXXXXXXXXXXXXXXXXXXXXXXXXXXXXXXXXXXXXXXXXXXXXX