----------------------------------------------------------------------------------------------------------------------------------------------------------------------------------------------------------------
----------------------------------------------------------------------------------------------------------------------------------------------------------------------------------------------------------------
----------------------------------------------------------------------------------------------------------------------------------------------------------------------------------------------------------------
----------------------------------------------------------------------------------------------------------------------------------------------------------------------------------------------------------------
----------------------------------------------------------------------------------------------------------------------------------------------------------------------------------------------------------------
----------------------------------------------------------------------------------------------------------------------------------------------------------------------------------------------------------------
---------------------------------------------------------------XX----------------------------------------------------------------------XX-----------------------------------------------------------------------
-----------XX-------------------------------------------------XXX---------------------------------------------------------------------XXX-------------------------------------------XX--------------------------
------E---XXX-----------------------------------------------EXXXX--------------------------------------------------------------------XXXX------------------------------------------XXX--------------------------
----------XXX----------------------------------------------EXXXXX-------------------------------------------------------------------XXXXX-----------------------------------------XXXX--------------------------
--------X-XXX---------------------------X------------------XXXXXX------------------------------------------------------------------XXXXXX----------------------------------------XXXXX--------------------------
-------XX-XXX-------------------------XXX-----------------XXXXXXX-------------XXX-X-----------------------------------------------XXXXXXX---------------------------------------XXXXXX-----------X--------------
-------XX-XXX-----------------E------XXXX----------------XXXXXXXX-------------XXX-XX---------------------------------------------XXXXXXXX--------------------------------------XXXXXXX-----------XX-------------
-----X-XX-XXX-----------------------XXXXX---------------XXXXXXXXX-----------XXXXX-XXX---------------------XX--------------------XXXXXXXXX-------------------------------------XXXXXXXX-----------XX-------------
----XX-XX-XXX--------X-------------XXXXXX--------------XXXXXXXXXX-------XXXXXXXXX-XXXXX-XXXXXXXXXXXXXXXXXXXX-------------------XXXXXXXXXX------------------------------------XXXXXXXXX-----------XXX------------
XXXXXX-XX-XXXXXXXXXXXXXXXXXXXXXXXXXXXXXXX--XXX---X-----XXXXXXXXXXXXXXXXXXXXXXXXXXXXXXXXXXXXXXXXXXXXXXXXXXXXX-----X-XXXXXXXXXXXXXXXXXXXXXXXXXX--------------------------XXXXXXXXXXXXXXXXXXXXXXXXXXXXXXXXXXXXXX---