----------------------------------------------------------------------------------------------------------------------------------------------------------------------------------------------------------------
----------------------------------------------------------------------------------------------------------------------------------------------------------------------------------------------------------------
----------------------------------------------------------------------------------------------------------------------------------------------------------------------------------------------------------------
-----------------------------------------------------------SSSSSSSSSSSSSSS--------------------------------------------------------------------------------------------------------------------------------------
-----------------------------SSSSSSSSSSSSSSSSSS-----------------------------------------------------------------SSSSSSSSSSSSSSSSSSSSSSSSSSSSSSSS----------------------------------------------------------------
----------------------------------------------------------------------------------------------------------------------------------------------------------------------------------------------------------------
--------------------------------------------------------------------------------------------------------XX------------------------------------------------------------------------------------------------------
------------------------------------------------------SS----------------------------------------------------SSS---------------------------------------------------?---------------------------------------------
----------------------------------------------------------------------------------------------------------------------------------------------------------------------------------------------------------------
------------------------------------------------------------------------------------------------------------S---------------------------------------------------------------------------------------------------
---------------------------------------------------------------------------------------------X----------------S-------------------------------------------------------------------------------------------------
---------XX--------------------------------------XXX-SSSS---------------------------SSS----X-XX---------------S-----------------------XX------------------------XXX---------------------------------------------
--------XXX---------X---------------------X--XX-------------------------------------------XX-XXX---------------------------------XXX-----------XX------------XXXX-----------------------------------------------
------EXXXX---------X--------------------XX--XX------------------------------------------XXX-XXX-------------------------------X-XXX-----------XX---------XXXXX-------------------------------------------------
------XXXXX---------X-X--------------E---XX--XX-----------------------------------------XXXX-XXX--------------------------EE---X-XXX-----------XX--------XXXX---------------------------------------------------
XXXXXXXXXXXXXXXXXXXXXXXXXXXXXXXXXXXXXXXXXXX--XX------XXXXXXXXXXXXXXX-X--X--XXXXXX-XXXXXXXXXXXXXXXXXXXXXX-X--XXXXXXXXXXXXXXXXXXXXXXXX---X---XX--XX----XXXXXXXX------XX-XXXX--XXXXXXXX-X-X--X--------X-XXXXXXXXXXX