----------------------------------------------------------------------------------------------------------------------------------------------------------------------------------------------------------------
----------------------------------------------------------------------------------------------------------------------------------------------------------------------------------------------------------------
----------------------------------------------------------------------------------------------------------------------------------------------------------------------------------------------------------------
-------------------------------------------------------------------------------------------------------------------------------------------------SSSSSSSSSSSSSSSSSSSSSSSS---------------------------------------
----------------------------------------------------------------------------------------------------------------------------------------------------------------------------------------------------------------
----------------------------------------------------------------------------------------------------------------------------------------------------------------------------------------------------------------
----------------------------------------------------------------------------------------------------------------------------------------------------------------------------------------------------------------
-----------------------------------------------XX---------------------------------------------------------------------------------------------------------------------------------------------------------------
-------------------------------------------E--------------------------------------------------------------------------------------------------------------------------------------------------------------------
-----------------------------------------------------------XS---------------------------------------------------------------------------------------------------------------------------------------------------
----------------------------------------------------------XX--------XX--------XX--S-----------------------------------------------------------------------------------------------------------------------------
---------------------------------------------------------XXX-------XXX-------XXX---------------------------------------------------------XX--XX-----XXX------XXXX-----------------------------------------E-----
--------------------------------------------------------XXXX------XXXX------XXXX--------------------------------------------------------XXX--------------------------------------------------------------<>-----
------------------------------------------------------XXXXXX-----XXXXX-----XXXXX----------------E--E---E-------------------------------XXXX---------------------------------------------------X----------[]-----
X----------XXXXXXXXXXXXXX-----------------------------XXXXXX-----XXXXXX---XXXXXXXXXXXXXXXXXXXXXXXXXXXXXXXXXXXXXXXXXXXXXXXXXXXXXXXXXXXXXXXXX------------------------------XXXXXXXXXXXXXXXXXXXXXX----XXX-XXXXXXXXX
X----------XXXXXXXXXXXXXX-----------------------------XXXXXX-----XXXXXX--XXXXXXXXXXXXXXXXXXXXXXXXXXXXXXXXXXXXXXXXXXXXXXXXXXXXXXXXXXXXXXXXXX------------------------------XXXXXXXXXXXXXXXXXXXXXX----XXX-XXXXXXXXX