----------------------------------------------------------------------------------------------------------------------------------------------------------------------------------------------------------------
----------------------------------------------------------------------------------------------------------------------------------------------------------------------------------------------------------------
----------------------------------------------------------------------------------------------------------------------------------------------------------------------------------------------------------------
----------------------------------------------------------------------------------------------------------------------------------------------------------------------------------------------------------------
----------------------------------------------------------------------------------------------------------------------------------------------------------------------SSSSSSSSSSSSSSSSSSSSSSSSSSSSSSSSSSSS------
----------------------------------------------------------------------------------------------------------------------------------------------------------------------------------------------------------------
-------------------------------------------------------------------------------------------------XX--------------------------------------------------------------------------------------------------------XXX--
-----------------------------------------------------------------------------XX-----------------XXX------------------------------------------------------------------------------------------------------------S
-----------------------------------------------------------------------------XX----------------XXXX-------------------------------------------------------------------------------------------------------------
-----------------------------------------------------------------------------XX---------------XXXXX-------------------------------------------------------------------------------------------------------------
--------------------------------------------------------------------------X--XX--------------XXXXXX-----------------------------------------------------------------------------S-------------S----------------S
-------------XX--X------------------------------XX----------------------XXX--XX--------------XXXXXX---S--SQS---------------------------XX--X---------------Q-----------------XX------------X----------QQQ-------
-X----------XXX--XX------------X---------------XXX----------------------XXX--XX------------X-XXXXXX--------------------------------E--XXX--XX-------------------------------XXX---X------X-X-X--X---------------
-X---------XXXX--XXX-----X-X---XX-------------XXXX--------------------XXXXX--XX-----------XX-XXXXXX----------------------------------XXXX--XXX-----------------------------XXXX---XX---X-X-X-X--X---------------
-X--------XXXXX--XXXX-E-XX-X-E-XX-----------XXXXXX-------------------XXXXXX--XX----------XXX-XXXXXX---------------------------------XXXXX--XXXX---------------------------XXXXX-E-XX---X-X-X-XE-X---------------
XXXXXXXXXXXXXXX--XXXXXXXXXXXXXXXXXXXXXXXXXXXXXXXXX--XXXXXXX--XXXXXXXXXXXXXX--XXXXXXXXXXXXXXX-XXXXXXXXXXXXXXX--XXXXXXXXXXXXXXXXXXXXXXXXXXX--XXXXXXXXXXXXXXXXXXXXXXXXXXXXXXXXXXXXXXXXXXXXXXXXXXXXXXXXXXXXXX------X