----------------------------------------------------------------------------------------------------------------------------------------------------------------------------------------------------------------
----------------------------------------------------------------------------------------------------------------------------------------------------------------------------------------------------------------
----------------------------------------------------------------------------------------------------------------------------------------------------------------------------------------------------------------
----------------------------------------------------------------------------------------------------------------------------------------------------------------------------------------------------------------
---------------------------------------------------------------------------E------------------------------------------------------------------------------------------------------------------------------------
----------------------------------------------------------------------------------------------------------------------------------------------------------------------------------------------------------------
----------------------------------------------------------------------------------------------------------------------------------------------------------------------------------------------------------------
-----------------------------------------------------------------------------XX----------------------------------------------------------XX---------------------------------------------------------------------
----------------------------------------------------------------------------XXX-----------XXXX-------------------------------------------XX---------------------------------------------------------------------
---------------------------------------------------------------ooo---------XXXX--------------------------------------------------------X-XX---------------------------------------------------------------------
-----------------------XXXXXXXXXX-----------------------------------------XXXXX--------------------------------------------------------X-XX------------oo------------------------------------SSSSSS-------------
-------------------------------------------------------------------------XXXXXX------------------------------------------------------X-X-XX---------------------------------------------------------------------
------------------------------------------------------------XXXX--------XXXXXXX-----------------------------------------------------XX-X-XX---------------------------------------------------------------------
-----------------------------------------------------------XXX---------XXXXXXXX----------------------------------------------------X-X-X-XX---------------------------------------------------------------------
----------------------------------------------------------XXX---------XXXX-XXXX---------------------------------------------------XX-X-X-XX--------------------------------------------------------------------X
XXXX---XXXXXXXXXXXXXXX---------------------------XXXXXXXXXXXX-----XXXXXXXX-XXXXXXXXX-X-------------------------X-XXXXXXXXXXXXXXXXXXXXX-X-XXXXXXXXXXXXX---XXXXXXXXXXXXXXXX-XXXXXXXX-X-XXXXXXXXXXXXXXXXXXXXXX-XXXX