----------------------------------------------------------------------------------------------------------------------------------------------------------------------------------------------------------------
----------------------------------------------------------------------------------------------------------------------------------------------------------------------------------------------------------------
----------------------------------------------------------------------------------------------------------------------------------------------------------------------------------------------------------------
----------------------------------------------------------------------------------------------------------------------------------------------------------------------------------------------------------------
-----------E------------E---------------------------------------------------------------------------------------------------------------------------------------------------------------------------------------
----------------------------------------------------------------------------------------------------------------------------------------------------------------------------------------------------------------
---------------------------------------XX----------------------------------------------------------------------------------------------------------------------------------XX-----------------------------------
------------XX-----------XX-----------XXX-----------------------------------------------------------------------------------------------XX------------XX------------------XXX-----------------------------------
-------E---XXX----------XXX-----------XXX---------------------------------------------------------------------------------X-----------EXXX-----------XXX------------------XXX-----------------------------------
X---------XXXX---------XXXX---------XXXXX--------------------------------------------------------------------------------------------EXXXX----------XXXX----------------X-XXX-------------------XX--------------
X---------XXXX--------XXXXX--------XXXXXX--------------------------------------XXXX--------------------------------------------------XXXXX---------XXXXX---------------XX-XXX------------------XXX--------------
X-------XXXXXX-------XXXXXX--------XXXXXX--------X----------------------------------------------------------------------------------XXXXXX--------XXXXXX---------------XX-XXX----------------X-XXX--------------
X-------XXXXXX-------XXXXXX--------XXXXXX--------XX--------------------------------------------------------------------------------XXXXXXX-------XXXXXXX-------------X-XX-XXX----------E----XX-XXX--------------
X-----X-XXXXXX-----X-XXXXXX--------XXXXXX--------XXXX-----------------------------------------------------------------------------XXXXXXXX------XXXXXXXX------------XX-XX-XXX---------------XX-XXX--------------
X----XX-XXXXXX----XX-XXXXXX--------XXXXXX--------XXXX----------------------------------------------------------------------------XXXXXXXXX-----XXXXXXXXX--------X--XXX-XX-XXX--------X-------X-XXX--------------
XXXXXXXXXXXXXXXXXXXXXXXXXXXXXXXXX--XXXXXX-------XXXXXXXXXXXXXXXXX--X-------------------XXXXXXXXXXXXXXXXXXXXXXXXXXX---XXXX-------XXXXXXXXXXXXXXXXXXXXXXXXXXXXXXXXXXXXXX-XX-XXXXXXXXXXXXXXXXXXXXXXXXXXXXXXXXXXXXXX