----------------------------------------------------------------------------------------------------------------------------------------------------------------------------------------------------------------
----------------------------------------------------------------------------------------------------------------------------------------------------------------------------------------------------------------
----------------------------------------------------------------------------------------------------------------------------------------------------------------------------------------------------------------
----------------------------------------------------------------------------------------------------------------------------------------------------------------------------------------------------------------
--------------------------------------------------------------------------------------------------------------SSSSSSSSS----------SSSSSSSSSSSSSSSSSSSSSSSSSSSSS--------------------------------------------------
----------------------------------------------------------------------------------------------------------------------------------------------------------------------------------------------------------------
-------------------------------------------------------------------------------------------------------------------------XXX------------------------------------------------------------------------------------
----oo--S-----------------------------------------------------------XXX-------------------------------------------------------SSS-----------------------------------------XX--------------------------X---------
-------------------------------------------------------------------XXXX--------------------------------------------------------------------------------------------------XXX-------------------------XX---------
-----------------------------------X------------------------------XXXXX-------------------------------------------------------S-----------------------------------------XXXX------------------------XXXX-------X
----------------------------------XX-----------------------------XXXXXX------------------------------------------------------------------------------------------------XXXXX-----------------------XXXXX------XX
XXX----XXX-----------------------XXX----------------------------XXXXXXX-----------------------------------------------X--X----SSS---------X----X-------------XX-------XXXXXX---------------------XXXXXX------XXX
--------------------------------XXXX---------------------------XXXXXXXX----------------------------------------------XX--XX------------X--X-X--X-----------EXXX------XXXXXXX---------------------XXXXXX-----XXXX
-------------------------------XXXXX--------------------------XXXXXXXXX---------------------------------------------XXX--XXX----------XX--X-X--XX---------EXXXX----XX-XXXXXX--------------------XXXXXXX----XXXXX
------------------------------XXXXXX-------------------------XXXXXXXXXX---------X----------------------------------XXXX---------------XX--X-X--XX----E----XXXXX----XX-XXXXXX--------X----------XXXXXXXX---XXXXXX
---X---------XXXXXXXXXXXXXXXXXXXXXXX-------XX---------XX---XXXXXXXXXXXXXXXXXXXXXXXXXXX-XXX-X-XX-XX---XXX---XX--XXXXXXXX-------XXXXXXXXXXX-X-XXXXXXXXXXXXXXXXXXXXXXXXXXXXXXXXXXXXXXXXXXXXXXXXXXXXXXXXXXXXXXXXXXXX