----------------------------------------------------------------------------------------------------------------------------------------------------------------------------------------------------------------
----------------------------------------------------------------------------------------------------------------------------------------------------------------------------------------------------------------
----------------------------------------------------------------------------------------------------------------------------------------------------------------------------------------------------------------
----------------------------------------------------------------------------------------------------------------------------------------------------------------------------------------------------------------
----------------------------------------------------------------------------------------------------------------------------------------------------------------------------------------------------------------
----------------------------------------------------------------------------------------------------------------------------------------------------------------------------------------------------------------
----------------------------------------------------------------------------------------------------------------------------------------------------------------------------------------------------------------
-------------------------XX------------------------------XX----------------------XX-----------------------------------------------------------------------XXX---------------------------------------------------
------------------------XXX------------------------------XX---------------------XXX-----------------------------------------------------------------------XXX---------------------------------------------------
-----------X------------XXX------------------------------XX--------------------XXXX----------------------------------------------------X------------------XXX---------------------------------------------------
-----------X----------X-XXX---------------------------X--XX-------------------XXXXX---------------------------------------------------XX---------------X--XXX--------------------X------------------------------
---------XXX----------X-XXX--------------------------XX--XX------------------XXXXXX---------------------------X--X-----------------X--XX--------------XX--XXX-------------------XX--------------------------XXX-
E--------XXX--------X-X-XXX---------------------E---XXX--XX-----------------XXXXXXX---------------------------XX-XX---------------XX--XX-------------XXX--XXX------------------XXX----------------------XXXXX---
--------XXXX-------XX-X-XXX------------------------XXXX--------------------XXXXXXXX-------------------------X-X--XXX-------------XXX--XX------------XXXX--XXX-----------------XXXX-------------------XXXXXX-----
--------XXXX------XXX-X-XXX--------X--------------XXXXX-------------------XXXXXXXXX-------------------------X-X--XXXX-----------XXXX--XX-----------XXXXX--XXX----------------XXXXX------------------XXXXX-------
XXXXXXXXXXXXXXXXXXXXX-X-XXXXXXXXXXXXXXXXXXXXXXXXXXXXXXXXXXXXXXXXXXXXXXXXXXXXXXXXXXXXXXXXXXXXXX---XXXXXXXXXXXX-XXXXXXXXXXXXXXXXXXXXXXXXXXXXXXXXXXXXXXXXXX--XXXXXXXXXXXXXXXXXXXXXXXX--------------XXXXXXXX------XX