----------------------------------------------------------------------------------------------------------------------------------------------------------------------------------------------------------------
----------------------------------------------------------------------------------------------------------------------------------------------------------------------------------------------------------------
----------------------------------------------------------------------------------------------------------------------------------------------------------------------------------------------------------------
----------------------------------------------------------------------------------------------------------------------------------------------------------------------------------------------------------------
---------------------------------------------------------------------------------------------------------------------------------------------------E------------------------------------------------------------
----------------------------------------------------------------------------------------------------------------------------------------------------------------------------------------------------------------
----------------------------------------------------------------------------------------------------------------------------------------------------------------------------------------------------------------
------------------------------------------------------------------------------------------------------------------SSSSSSSS--------------------------XX-----------------------------------------XX---------------
-----------------------------------------------------------------------------------------------------------------------------------------------E---XXX----------------------------------------XXX---------------
---------XX----------X-----------------------------------------------------------------------------------------------------------------------------XXX---------------------------------------XXXX---------------
--------XXX--o------XX----------------------------------------------------------------------------------------------E--E-------------------------X-XXX--------------------------------------XXXXX---------------
-------XXXX--------XXX---------------------------S----------------------------------------------------------------SSSSSSSSS---------------------XX-XXX---------------------X----------------XXXXX---------------
------XXXXX--------XXX---------------------------------E----------------------------------------------------------------------------------------XX-XXX--------------------XX--------------X-XXXXX---------------
-----XXXXXX--------XXX------------------------------------------------------------------------------------------------------------------------X-XX-XXX-------------------XXX------------XXX-XXXXX---------------
----XXXXXXX--------XXX--------------------------------------------------------------------------------------E-E------------------------------XX-XX-XXX------------------XXXX-----EE-----XXX-XXXXX---------------
XXXXXXXXXXXXXXXXXXXXXXXXXXXXXXXXXX---XXXX-XXXXXXXXXXXXXXXXXXXXXXXXXXXXXXXXX-XXXXX-XXXXXXXX---X---XXXXXXXXXXXXXXXXXXXXXXXXXXXXXXXX----XXXXXXXXXX-XX-XXXXXXXXXXX--X-X--XXXXXXX--XXXXXXXXXXXXX-XXXXXXXXXXXXXXXXXXXX