----------------------------------------------------------------------------------------------------------------------------------------------------------------------------------------------------------------
----------------------------------------------------------------------------------------------------------------------------------------------------------------------------------------------------------------
----------------------------------------------------------------------------------------------------------------------------------------------------------------------------------------------------------------
----------------------------------------------------------------------------------------------------------------------------------------------------------------------------------------------------------------
----------------------------------------------------------------------------------------------------------------------------------------------------------------------------------------------------------------
---------------------------------------------------------ooooooooo--E-------------------------------------------------------------------------------------------------------------------------------------------
--------XX---------------------SSSSSSSSSSS-------SSSSSSSSSSSSSSSSSSSSS---SSSS-----------------------XX----------------------------------------------------------SSSSSSSSS---------------------------------------
-------XXX------------------------------------------------------------E----------------------------XXX-------------------------------------------------XX-------------------------------------------------------
------XXXX---------------------------------------------------------------------------------------EXXXX------------------------------------------------XXX-------------------------------------------------------
------XXXX--------------------------E------------------------------------------------------------XXXXX------------------------------------------------XXX-------------------------------------------------------
----X-XXXX----------------------SSSSSSSSSS----------------SSSSSSSSSSS--X------------------------XXXXXX-------------SSSSSSS--------------------------X-XXX--------SSSSSSSSS--------------------------------------
---XX-XXXX------------------------------------------------------------XX-----------------------XXXXXXX---------------------------------------------XX-XXX-------------------------------------------------------
--XXX-XXXX-----------------------------------------------------------XXX----------------------XXXXXXXX---------------------------------------------XX-XXX-------------------------------------------------------
-X-XX-XXXX---------------------------E------------------------E-----XXXX---------------------XXXXXXXXX-------------------------------------------X-XX-XXX------------E------------------------------------------
XXXXX-XXXX--------------------XXXXXXXXXXXX--------------XXXXXXXXXXXXXXXXXXXXX---------------XXXXXXXXXX-------X----------------------------------XX-XX-XXX-XXXXXXXXXXXXXXXXXXXXXXXXXXXX--------------------------
XXXXX-XXXXXXXXXXXXXX---XXX----XXXXXXXXXXXX---X-X--------XXXXXXXXXXXXXXXXXXXXX-----X--X----X-XXXXXXXXXXXXXXXXXXXXXXXXXXXXXXXXXXXXXXX--XXXXXXXXXXXXX-XX-XXXXXXXXXXXXXXXXXXXXXXXXXXXXXXXX-----X----------X---------