----------------------------------------------------------------------------------------------------------------------------------------------------------------------------------------------------------------
----------------------------------------------------------------------------------------------------------------------------------------------------------------------------------------------------------------
----------------------------------------------------------------------------------------------------------------------------------------------------------------------------------------------------------------
----------------------------------------------------------------------------------------------------------------------------------------------------------------------------------------------------------------
----------------------------------------------------------E-----------------------------------------------------------------------------------------------------------------------------------------------------
----------------------------------------------------------------------------------------------------------------------------------------------------------------------------------------------------------------
------------------------------------------------------------------------------------------------------------------------------------------------------------------o---------------------------------------------
-----------------------------------------------------------XX-------------------------------------------------------------------XX-----------------------------------------S------------------------------------
-----------------------------------------------------------XX-------------------------------------------------------------------XX------------------------------------------------------------------------------
---------------------------------------------------------X-XX-----------------------------------X-------------------------------XX------------------------------------------------------------------------------
---------------------------------------------------------X-XX-----------------------------------X----------------------------X--XX----------------------------------------E-EE-E--------------------------------
---------------------------XXX-------------------------X-XXXX---QQQQ----------------------------X---------------------------XX--XX----------------------------------XXXXXXXXXXXXXX------------------------------
-------E-----------------------------------------------X-XXXX-----------------------------------X--------------------------XXX--XX---------------------------------XX------------X---------------X----------E---
-----------------------------------------------------X-X-XXXX-----------------------------------X-------------------------XXXX--XX-------------------XXXXXXXXXXXX--XX------------X--XX-----------X--------------
----------------------XXX--------------------E------XX-X-XXXX-----------------E---X-------------X------------------------XXXXX--XX----------------E-XXX------X-----XX------------X---X-----------X--------------
XXXXXXXXXXXXX--XXXXX-----------------------XXXXXXXXXXX-X-XXXXXXXXXXXXXX--X-XXXXXXXXXXXXXXXXXXXXXXX-------X---XXXXXXXXXX-XXXXXX--XXXXXXXXXXXXXXXXXXXXXXX------X-----XX------------X---XXXXXXXXXXXXXXXXXXXXXXXXXXX