----------------------------------------------------------------------------------------------------------------------------------------------------------------------------------------------------------------
----------------------------------------------------------------------------------------------------------------------------------------------------------------------------------------------------------------
----------------------------------------------------------------------------------------------------------------------------------------------------------------------------------------------------------------
----------------------------------------------------------------------------------------------------------------------------------------------------------------------------------------------------------------
----------------------------------------------------------------------------------------------------------------------------------------------------------------------------------------------------------------
----------------------------------------------------------------------------------------------------------------------------------------------------------------------------------------------------------------
---------------------------------------------------------------------XX-----------------------------------------------------------------------------------------------------------------------------------------
-----------------XX----------------XX-------------------------------XXX----------------------------------------------------------------------------------XX-----------------------------------------------------
----------------XXX---------------XXX------------------------------XXXX---------------------------------------------------------------------------------XXX-----------------------------------------------------
---------------XXXX--------------XXXX-----------------------------XXXXX------------------------------------------------------------------------X------EXXXX------------------------------X---------------X------
--------------XXXXX-------------XXXXX----------------------------XXXXXX-----------------------------------------------------------------------XX------XXXXX-------------------XSS-SQ----XX--------------XX------
-------------XXXXXX------------XXXXXX---------------------------XXXXXXX---QQQQ---------------------------------------------------------------XXX-----XXXXXX------------------XX---------XX-------------XXX------
------------XXXXXXX-----------XXXXXXX--------------------------XXXXXXXX---------------------------------------------------------------------XXXX----XXXXXXX-----------------XXX---------XX------------XXXX------
-----------XXXXXXXX----------XXXXXXXX-------------------------XXXXXXXXX--------------------------------------------------------------------XXXXX---XXXXXXXX----------------XXXX---------XX-----------XXXXX------
----------XXXXXXXXX---------XXXXXXXXX--------X---------------XXXXXXXXXX-------------------------------------------------------------------XXXXXX--XXXXXXXXX---------------XXXXX---SS----XX----------XXXXXX------
XXXXXXXXXXXXXXXXXXXXXXXXXXXXXXXXXXXXXXXXXXXXXXXXXXXXXXXX---XXXXXXXXXXXXXXXXXXXXX-XXXXXXXXXXXXXXXXXXXXXXXXXXXXXXXXXXXXXXXXXXXXXXXXXXXXXXXXXXXXXXXXXXXXXXXXXXXXXXXXXXXXXXXXXXXXXX-------XXXXXXXX--XXXXXXXXXX------