----------------------------------------------------------------------------------------------------------------------------------------------------------------------------------------------------------------
----------------------------------------------------------------------------------------------------------------------------------------------------------------------------------------------------------------
----------------------------------------------------------------------------------------------------------------------------------------------------------------------------------------------------------------
----------------------------------------------------------------------------------------------------------------------------------------------------------------------------------------------------------------
----------------------------------------------------------------------------------------------------------------------------------------------------------------------------------------------------------------
----------------------------------------------------------------------------------------------------------------------------------------------------------------------------------------------------------------
------------------------------------------X-----------------XX-------------------X-------------------------------------------------------------------------------SSSSSSS----------------------------------------
---------XX--------------------E---------XX----XX-----------XX------------------XX------------------------------------------------------------------------------------------------------------------------------
--------XXX-----------------------------XXXXX--------------XXX-----------------XXX------------------------------------------------------------------------------------------------------------------------------
-------XXXX----------------------------XXXX---------------XXXX---------------EXXXX-----------------------------------------------X-X----------------------------------------------------------------------------
------XXXXX---------------------------XXXXX---------------XXXX---------------XXXXX---------------------------------------------XXXXX--S-----------XX-------------SSSSSSS----------------------------------------
-----XXXXXX--------------------------XXXXXX---------------XXXX--------------XXXXXX-----------------------------------X---------XXXXX--------------XX------------------------------------------------------------
----XXXXXXX-------------------------XXXXXXX-E-------------XXXX-------------XXXXXXX-----------------------------------X-------XXXXXXX--------------XX------------------------------------------------------------
---XXXXXXXX------------------------XXXXXXXX<>-------------XXXX------------XXXXXXXX------------X----------------------X------XXXXXXXX--------------XX------------------------------------------------------------
XXXXXXXXXXXXXXXXXXXXXXXXXXXXXXXXXXXXXXXXXXX[]-------------XXXX-----------XXXXXXXXXXXXXXXXXXXXXX----------------XXXXXXXXXXXXXXXXXXXXXX-XXXXXXXXXXXXXXXXXXXXXXXXXXXXXXXXXX------------XXXXXXXXX-------------------
XXXXXXXXXXXXXXXXXXXXXXXXXXXXXXXXXXXXXXXXXXX[]------X------XXXX-----------XXXXXXXXXXXXXXXXXXXXXX----------------XXXXXXXXXXXXXXXXXXXXXX-XXXXXXXXXXXXXXXXXXXXXXXXXXXXXXXXXX------------XXXXXXXXX----XXXXXXXXXX--XXX