----------------------------------------------------------------------------------------------------------------------------------------------------------------------------------------------------------------
----------------------------------------------------------------------------------------------------------------------------------------------------------------------------------------------------------------
----------------------------------------------------------------------------------------------------------------------------------------------------------------------------------------------------------------
----------------------------------------------------------------------------------------------------------------------------------------------------------------------------------------------------------------
----------------------------------------------------------------------------------------------------------------------------------------------------------------------------------------------------------------
----------------------------------------------------------------------------------------------------------------------------------------------------------------------------------------------------------------
----------------------------------------------------------------------------------------------------------------------------------------------------------------------------------------------------------------
--------------S-------------------------------------------------------------------------------------------------------------------------------------------------------------------------------------------------
-----------------------------------------------------------------------------------------------------------------------------------------------SS---------------------------------------------------------------
-----------------------------------------XSS----------------------------------------------------ooooo----------X------------------------------------X-----------------------------------------------------------
----------------------------------------XX-----------------------------------------------------XXXXXXX--------XX--oo-------------------------------XX-----------------------------------------------------E-----
-------------XX------------------------XXX--SS----------------------------XX--XX-----------------------------XXX----------------------------------XXX-------XXX---------------------------XXXXXXXXXXXXXXXXX---X-
---------XXXXX------------------------XXXX-------------------------------XXX--XX----------------------------XXXX---------------------------------XXXX---S--------------------------------XX-------------------X-
-----XXXXXXX-------------------------XXXXX---SSS------------------------XXXX--XX----XXXXXXXX---------------XXXXX--------------------------------XXXXX-----------------------------------XXX-------------------XX
--XXXXXXX-----------------X---------XXXXXX-----------------------------XXXXX--XX----X------X---------------XXXXX-----------X-E-----------------XXXXXX---------------------------------XXXXX-------------------X-
XXXXXXXX------XXXXXXXXXXXXXXXXXXXXXXXXXXXXX------XXXXXXXXXXXXXXXXXXXXXXXXXXX--XX----X------X---------------XXXXXXXXXXXXXXXXXXXXXXXXXXXXXXXXXXX-XXXXXXXXXX--------------------------XXXXXXXX-------------------X-