----------------------------------------------------------------------------------------------------------------------------------------------------------------------------------------------------------------
----------------------------------------------------------------------------------------------------------------------------------------------------------------------------------------------------------------
----------------------------------------------------------------------------------------------------------------------------------------------------------------------------------------------------------------
-----------------------------------------------------------------------------------------------------------------------------------------------------------------------------------------------SSSSSSSSSSSSSSSSS
----------------------------------------------------------------------------------------------------------------------------------------------------------------------------------------------S-----------------
----------------------------------------------------------------------------------------------------------------------------------------------------------------------------------------------------------------
----------------------------------------------------------------------------------------------------------------------------------------------------------------------------------------------------------------
----------------------------------------------------XX------------------------------XX-------------------------XX-----------------------------------------------------------------------------------------------
------------------------------------------------------------------X-XXX--------E---XXX--------------------------------------------------------------------------------------------------------------------------
-----------------------------------------------------------------XX----------------XXX------------------------------------------------------------------------------X---------------------------XXXXX-----------
---------------------------------------------------------------XXXX--------------X-XXX------------------------------------XXX--o-----------------------------------XX----------X---------------XXXXXX-----------
------------------XXXXX-XXXX----------------------------------XXXXX-------------XX-XXX---S-------------------------------XXXX-------------------------------------XXX---------XX--------------XXXXXXX-----------
-------------------------------------------------------------XXXXXX-------------XX-XXX----------------------------------XXXXX------------------------------------XXXX--------XXX---X---------XXXXXXXX---XXXX----
------------------------------------------------------------XXXXXXX-----------X-XX-XXX-------------X-------------------XXXXXX--------------X--------------------XXXXX-------XXXX---XX-------XXXXXXXXX-----------
-----------------------------------------------------------XXXXXXXXX---------XX-XX-XXX---------XXXXX------------------XXXXXXXXXXXXXXXXXXXXXX-------------------XXXXXX------XXXXX---XXXX----XXXXXXXXXXX----------
-----------------------------------------------------------XXXXXXXXXXXXXXXXXXXX-XX-XXXXXXXXXXXXXXXXX------------------XXXXXXXXXXXXXXXXXXXXXX----------------X--XXXXXX--XXX-XXXXXXXXXXXXXXXXXXXXXXXXXXX----------