----------------------------------------------------------------------------------------------------------------------------------------------------------------------------------------------------------------
----------------------------------------------------------------------------------------------------------------------------------------------------------------------------------------------------------------
----------------------------------------------------------------------------------------------------------------------------------------------------------------------------------------------------------------
----------------------------------------------------------------------------------------------------------------------------------------------------------------------------------------------------------------
SSSSSS-----------------------------------------------------------------------------------------------------------------------------------------------------------------------------------SSSSSSSSSSSSSSSSSSSSSSS
----------------------------------------------------------------------------------------------------------------------------------------------------------------------------------------------------------------
---------XX-----------------------------------------------------------------------------------------------------------------------------------------------------------------------------------------------------
--------------SSS----------------------------------XX------------------XX---------------------------------------------------------------------------------------------------------------------------------------
--------------------------------------------------XXX-----------------XXX---------------------------------------------------------------------------------------------------------------------------------------
------------------------------------------------XXXXX----------------XXXX-------------------------------------------------------------X------------XXX----------------------------------------------------------
--------------o---------------------------------XXXXX---------------XXXXX------------------------------------------------------------XX-----------XXXX------------------X---------------------------------------
----XX--------SSS-----------------------------X-XXXXX--------------XXXXXX----------------------SS-----------------------------------XXX---------XXXXXX-----------------XX------------XX--X----------X-----------
--EXXX--XXX-----------------------------------X-XXXXX-------------XXXXXXX---------------------------------------------------------X--XX-------EXXXXXXX---S------------XXX-----------XXX--XX---------X--X--------
--XXXX--------------------------------------X-X-XXXXX------------XXXXXXXX--------------------------------------------------------XX--XX-------XXXXXXXX---S-----------XXXX----------XXXX--XXX----X---X--X--------
-XXXXX--------------------------------------X-X-XXXXX-----------XXXXXXXXX--------X---------------------------------------------------XX------XXXXXXXXX--------------XXXXX---------XXXXX--XXXX---XX--XX-X--------
XXXXXX-------XXXXXXXXXXXXXXXXXXXXXXXXXXXXXXXX-X-XXXXXXXXXXXXXXXXXXXXXXXXXXXXXXXXXXXXXXXXXXXXXXXXXXXXXXXXXX-XXXXXX-XXXXXXXXXXXXXXXXXXXXX---XXXXXXXXXXXX------XXXXXXXXXXXXXXXXXXXXXXXXXXXXXXXXXXXXXXXXXXXX---X----