----------------------------------------------------------------------------------------------------------------------------------------------------------------------------------------------------------------
----------------------------------------------------------------------------------------------------------------------------------------------------------------------------------------------------------------
----------------------------------------------------------------------------------------------------------------------------------------------------------------------------------------------------------------
----------------------------------------------------------------------------------------------------------------------------SSSSSSSSSSSSSSS--------------------SSSSSSSSSSSSSSSSSSSSSSSSSSSS---------------------
----------------------------------------------------------------------------------------------------------------------------------------------------------------------------------------------------------------
----------------------------------------------------------------------------------------------------------------------------------------------------------------------------------------------------------------
----------------------------------------------------------------------------------------------------------------------------------------------------------------------------------------------------------------
-------------XXX------------------------------------------------------------------------------------------------------------------------------------------------------------------------------------------------
-----------EXXXX------------------------------------------------------------------------------------------------------------------------------------------------------------------------------------------------
-XX--------XXXXX---------------------------------------------------------------------------------------------------------------X----------------------------------XXX-------------------------------------------
XXX-------XXXXXX--------------------------------------------------------------------------------------X-----------------------XX----------------------------------XXX-------------------------------------------
XXX------XXXXXXX---S--Q------------------------------------------------------------------------------XX--------SS------------XXX-------------------E----------XX--XXX-------------------------------------------
XXX-----XXXXXXXX------------------E-------E---------------------------------------------------------XXX---------------------XXXX--XXXX------------<>---------XXX--XXX---X-----oooooooo--------------------------
XXX----XXXXXXXXX-----------------------------------------------------------------------------------XXXX--------------------XXXXX------------------[]--------XXXX--XX--------------------------------------------
XXX---XXXXXXXXXX----------------------------------------------------------------------------------XXXXX-------------------XXXXXX-----------------XXXXXXXXX-XXXXX--XXX---------XXXXXXXX--------------------------
XXXXXXXXXXXXXXXXXXXXXXXXXX-XXXXXXXXXXXXXXXXXXXXXXXX-X-X------------------------------XXXX-------X-XXXXX---XXXXXXXXXXXXXXX-XXXXXX-----------------XXXXXXXXXXXXXXX--XXX---------XXXXXXXX--------------------------