----------------------------------------------------------------------------------------------------------------------------------------------------------------------------------------------------------------
----------------------------------------------------------------------------------------------------------------------------------------------------------------------------------------------------------------
----------------------------------------------------------------------------------------------------------------------------------------------------------------------------------------------------------------
----------------------------------------------------------------------------------------------------------------------------------------------------------------------------------------------------------------
----------------------------------------------------------------------------------------------------------------------------------------------------------------------------------------------------------------
----------------------------------------------------------------------------------------------------------------------------------------------------------------------------------------------------------------
---------XX-----------------------------XX------------------XX---------------XX------------------------------------------EXXXX----------SSSSSSSSSSSS------------------------------XX--------XX---------XXX------
---------XX----------------------------XXX----X------------XXX--------------XXX------------------------------------------XXXXX---------------------------------------------------XXX--------XX---------XXX------
-------XXXX---------------------------XXXX----------------XXXX-------------XXXX-----------------------------------------XXXXXX--------------------------------------------------XXXX--------XX---------XXX------
-------XXXX--------------------------XXXXX---------------XXXXX------------XXXXX-------------------------------------X--XXXXXXX-------------------------------------------------XXXXX--------XX---------XXX------
-------XXXX-----------------XX------XXXXXX--------------XXXXXX-----------XXXXXX---------------------------------------XXXXXXXX------------SSSSSSSSSS--------------------------XXXXXX--------XX---------XXX------
-----X-XXXX----------------XXX-----XXXXXXX-------------XXXXXXX----------XXXXXXX--------------------------------------XXXXXXXXX-----------------------------------------------XXXXXXX--------XX---------XXX------
----XX-XXXX---------------XXXX----XXXXXXXX------------XXXXXXXX---------XXXXXXXX-------------------------------------XXXXXXXXXX----------------------------------------------XXXXXXXX--------XX---------XXX------
---XXX-XXXX--------------XXXXX---XXXXXXXXX-----------XXXXXXXXX--------XXXXXXXXX------------------------------------XXXXXXXXXXX----------------E--E--E----------------------XXXXXXXXX--------XX---------XXX------
XXXXXX-XXXX----------XXXXXXXXXXXXXXXXXXXXXXX-----XXXXXXXXXXXXXXXXXXXXXXXXXXXXXXX----------XXXXXXXXXXXXXXXXX-----XXXXXXXXXXXXXXXXXXXXXXXXXXXXXXXXXXXXXXXXXXXXXXXXXXXX----XXXXXXXXXXXXXXX-----XXXXX------XXX------
XXXXXX-XXXXX---------XXXXXXXXXXXXXXXXXXXXXXX-----XXXXXXXXXXXXXXXXXXXXXXXXXXXXXXX----------XXXXXXXXXXXXXXXXX-----XXXXXXXXXXXXXXXXXXXXXXXXXXXXXXXXXXXXXXXXXXXXXXXXXXXX----XXXXXXXXXXXXXXX-----XXXX-------XXX------