----------------------------------------------------------------------------------------------------------------------------------------------------------------------------------------------------------------
----------------------------------------------------------------------------------------------------------------------------------------------------------------------------------------------------------------
----------------------------------------------------------------------------------------------------------------------------------------------------------------------------------------------------------------
---------------------------------------------------------------------------------------------------------------XXX----------------------------------------------------------------------------------------------
----------------------------------------------------------------------------------------------SSSSSSSSSSSSSSSS-----SSSSSSSSSSSSSSSSS----------------------------------------------------------------------------
-------------------------------------------------------------------------------------------------------------------SSSSSS---------------------------------------------------------------------------------------
-------------------------------------------------------------------------------------------------------------------SSSSS----------------------------------------------------------------------------------------
-------SSSSSSSSS---------S----------------XX-----------------------------------------------SSSS--------------------SSSSSSSSS-----------X------------------------------------------------------------------------
----------------------------------------XXXX------------------------------------------------------------------------------------------XX------------------------------------------------------------------------
---------------------------------------XXXXX-----------------------------------------------------------------------------------------XXX------------------------------------------------------------------------
---------oo-E-----------S-------------XXXXXX------------------------------------------------------------------------oooo-------------XXX-----------------X------------------------------------------------------
--------SSSSSSSSS--------------------XXXXXXX---QQQ-----E-------X----------------------------SSS----Q?--------------SSSSSS-S-------XX-XXX----------------XX------------------------------------------------------
------------------------------------XXXXXXXX----------<>-----EXX--XXX---------------------------------------X--------------------XXX-XXX---------------XXX------------------------EXXXX-XX----------------------
XXXXXX-----------------------------XXXXXXXXX----------[]-----XXX-------------------------------------------XX-XXX---------------XXXX-XXX--------------XXXX-------------------------XXXX-------------------------
XX--------------------------------XXXXXXXXXX----------[]----XXXX--------------------------------------E-E-XXX------------EE----XXXXX-XXX-------------XXXXX-----------------------XXXXXX-------------------------
XX-----XXXXXXXXXXXXXXXXXXXXXX--XXXXXXXXXXXXXXXXXXXXXXXXXXXXXXXXX-------XX----------X---X---XXXXXXXXXXXXXXXXXX------XXXXXXXXXXXXXXXXX-XXXXXXXXXXXXXXXXXXXXXXXXXXXXXX-X-XXXXXXXXXXXXXXXXX----XXXXXXXXXXXX-XXXXXX--