----------------------------------------------------------------------------------------------------------------------------------------------------------------------------------------------------------------
----------------------------------------------------------------------------------------------------------------------------------------------------------------------------------------------------------------
----------------------------------------------------------------------------------------------------------------------------------------------------------------------------------------------------------------
----------------------------------------------------------------------------------------------------------------------------------------------------------------------------------------------------------------
----------------------------------------------------------------------------------------------------------------------------------------------------------------------------------------------------------------
----------------------------------------------------------------------------------------------------------------------------------------------------------------------------------------------------------------
---------------------------------------------------------------XX------------------------------------XX--------------------------------XX---------------------X--------------------------------EXX--------------
--------------------------------------------------------------XXX----X------------------------------XXX----------------XX-------------XXX--------------------XX--------------------------------XXX--------------
-------------------------------------------------------------XXXX----------------------------------XXXX------------------------------XXXX-------------------XXX-------------------------------XXXX--------------
------------------------------------------------------------XXXXX---------------------------------XXXXX-----------------------------XXXXX------------------XXXX------------------------------XXXXX--------------
-------XXXX-----------------------------------------------XXXXXXX---------------XX---------------XXXXXX----------------------------XXXXXX-----------------XXXXX-------------------X---------XXXXXX--------------
----------------------------------------------------------XXXXXXX--------------XXX--------------XXXXXXX---------------------------XXXXXXX----------------XXXXXX-------------------X--------XXXXXXX--------------
----------------------------------------------------------XXXXXXX-------------XXXX-------------XXXXXXXX--------------------------XXXXXXXX---------------XXXXXXX-------------------X-------XXXXXXXX-------------E
----------------------------------------------------------XXXXXXX------------XXXXX------------XXXXXXXXX-------------------------XXXXXXXXX--------------XXXXXXXX---------------E---X------XXXXXXXXX--------------
----------------------XXXXXXXXXXXXXXXXXXXXXXXXXXXXXXXXXXXXXXXXXXX------------XXXXX---------XXXXXXXXXXXX---------------------XXXXXXXXXXXXXXXXXXXXXXXXXXXXXXXXXXXXXXXXXXX---XXXXXXXXXXXXXXXXXXXXXXXXXXXXXXXXXXXXXX
----------------------XXXXXXXXXXXXXXXXXXXXXXXXXXXXXXXXXXXXXXXXXXX------------XXXXX---------XXXXXXXXXXXX---------------------XXXXXXXXXXXXXXXXXXXXXXXXXXXXXXXXXXXXXXXXXXX--XXXXXXXXXXXXXXXXXXXXXXXXXXXXXXXXXXXXXXX