----------------------------------------------------------------------------------------------------------------------------------------------------------------------------------------------------------------
----------------------------------------------------------------------------------------------------------------------------------------------------------------------------------------------------------------
----------------------------------------------------------------------------------------------------------------------------------------------------------------------------------------------------------------
----------------------------------------------------------------------------------------------------------------------------------------------------------------------------------------------------------------
----------------------------------------------------------------------------------------------------------------------------------------------------------------------------------------------------------------
----------------------------------------------------------------------------------------------------------------------------------------------------------------------------------------------------------------
---------------------------------------------------------------------------------------------------XX-----------------------------------------------------------------------------------------------------------
--------------------------------------------------------------------------------------------------XXX--------XX-------------------------------------------------------------------------------------------------
-------------------------------------------------------------------------------------------------XXXX-------XXX--------------E----------------------------------------------------------------------------------
------------------------------------------------------------------------------------------------XXXXX-------XXX-------------------------------------------------------------------------------------------------
-----------------------------------------------------------------------------------------------XXXXXX-------XXX-----------------------------------------------------------------------------------------SSSSS---
---------------------X------------------------------------E-----------------SS----------------XXXXXXX--SS---XXX---------------XX-X---------------XX---------QQQ-----------XX------------------------------------
-------------E------XX-----------------------------------<>----------------------------------XXXXXXXX-------XXX---------------XX-XX-------------XXX----------------------XXX------------------------------------
-------------------XXX-----------------------------------[]---------------------------------XXXXXXXXX-------XXX-------------X-XX-XXXX----------XXXX---------------------XXXX--------------------X---------------
------------------XXXX-----------------------------------[]----E-------------E-------------XXXXXXXXXX-------XXX------------XX-XX-XXXX---------XXXXX--------------------XXXXX---S----------------X---------------
XXXXXXXXXXXXXXXXXXXXXX---XXXX-XXXXXXXXXXXX-XX-XXXXXXXXXXXXXXXXXXXXXXXXXXXXXXXXXXXXXXXXXXXXXXXXXXXXXXXXXXXXXXXXXXXXXXX-XXXXXXX-XX-XXXXXXXXXXXXXXXXXXXXXXXXXXXXXXXXXXXXXXXXXXX-------XXX-X-X-XXXXXXXXXXXXXXXXXXXX-