----------------------------------------------------------------------------------------------------------------------------------------------------------------------------------------------------------------
----------------------------------------------------------------------------------------------------------------------------------------------------------------------------------------------------------------
----------------------------------------------------------------------------------------------------------------------------------------------------------------------------------------------------------------
----------------------------------------------------------------------------------------------------------------------------------------------------------------------------------------------------------------
----------------------------------------------------------------------------------------------------------------------------------------------------------------------------------------------------------------
-------------------------------------------------------------------------------------------------------------------------------------------oooooooooooooooo--E--------------------------------------------------
------------------SSSSSSSSSSSS-------------------------------XX------------------------------SSSSSSSSSS----------------------------------SSSSSSSSSSSSSSSSSSSSSSS--SSSS------------------------------------------
------------------------------------------------------------XXX------------------------------------------------------------------------------------------------E------------------------------------------------
-----------------------------------------------------------XXXX-------------------------------------------------------------------------------------------------------------------------------------------------
----------------------------------------------------------XXXXX------------------------------------------------X------------------------------------------------------------------------------------------------
---------------XX----SSSSSSSSS---------------------------XXXXXX---------------------------------------SSSSSSSSSX---------------------------SSSSSSSSSSSSSSSSSSSS-X---SS---X------------------<>------------------
---------------XX---------------------------------------XXXXXXX------------------------------------------------------------------------------------------------XX--------XX-----------------[]------------------
---------------XX---------------------------------------XXXXXXX------------------------------------------------------------------------------------------------XX--------XX-----------------[]------------------
---------------XX------E--------------------------------XXXXXXX---------------------------------------------------EE-E------------------------------E---E----XXXX--------XX-----------------[]----E-------------
XXXXXXXXXXXXXXXXXXXXXXXXXXXXXX----XX--------------------XXXXXXXXXXXXXXXXXXXXXXXXXXX------XXXXXXXXXXXXXXXXXXXXXXXXXXXXXXXXXXXXXXXXXXXXXXXXXXXXXXXXXXXXXXXXXXXXXXXXXXXXXXXXXXXXXXXXXXXXXXXXXXXXXXXXXXXXXX---------
XXXXXXXXXXXXXXXXXXXXXXXXXXXXXX----XX--------------------XXXXXXXXXXXXXXXXXXXXXXXXXXX------XXXXXXXXXXXXXXXXXXXXXXXXXXXXXXXXXXXXXXXXXXXXXXXXXXXXXXXXXXXXXXXXXXXXXXXXXXXXXXXXXXXXXXXXXXXXXXXXXXXXXXXXXXXXXX---------