----------------------------------------------------------------------------------------------------------------------------------------------------------------------------------------------------------------
----------------------------------------------------------------------------------------------------------------------------------------------------------------------------------------------------------------
----------------------------------------------------------------------------------------------------------------------------------------------------------------------------------------------------------------
----------------------------------------------------------------------------------------------------------------------------------------------------------------------------------------------------------------
----------------------------------------------------------------------------------------------------------------------------------------------------------------------------------------------------------------
----------------------------------------------------------------------------------------------------------------------------------------------------------------------------------------------------------------
------------------XX--------------------------------------------XX-----------------------------------------------------------------------------------------------------XX------------SSSSSSSSSSSSSSS------------
-----------------XXX----X------XX--------------------E---------XXX----------------------------------------------------------------------------------------------------XXX---------------------------------------
-----------------XXX------------------------------------------XXXX---------------------------------------------------------------------------------------------------XXXX---------------------------------------
-----------------XXX-----------------------------------------XXXXX--------------------------------------------------------------------------------------------------XXXXX------------------------E--------------
--------------XX-XXX----------------------------------------XXXXXX-------------------------------------------------------------XX----------------------------------XXXXXX------------------------QQQQQQQ--------
------------E-XX-XXX---------------------------------------XXXXXXX----------------------------------------E--------------------XX---------------------------------XXXXXXX---------------------------------------
------------X-XX-XXX--------------------------------------XXXXXXXX------------------------------------------------------------XXX--------------------------------XXXXXXXX---------------------------------------
------------X-XX-XXX-----------------------------------E-XXXXXXXXX------------------E-----------------------------------------XXX-------------B-----------B-----XXXXXXXXX--------------------------E------------
XXXXXXXXXX--X-XX-XXX-------------------------XXXXXXXXXXXXXXXXXXXXXXXXXXXXX----XXXXXXXXXXXXXXXXXXXXXXXXXXXXXXXXXXXXXXXXX---XXXXXXX----XXXXXXXXXXX----XXXXXXX-----XXXXXXXXXXXXXXXXXX------------XXXXXXXXXXXXXXXXXX
XXXXXXXXXX--X-XX-XXX-------------------------XXXXXXXXXXXXXXXXXXXXXXXXXXXXX----XXXXXXXXXXXXXXXXXXXXXXXXXXXXXXXXXXXXXXXXX---XXXXXXX----XXXXXXXXXXX----XXXXXXX-----XXXXXXXXXXXXXXXXXX------------XXXXXXXXXXXXXXXXXX