----------------------------------------------------------------------------------------------------------------------------------------------------------------------------------------------------------------
----------------------------------------------------------------------------------------------------------------------------------------------------------------------------------------------------------------
----------------------------------------------------------------------------------------------------------------------------------------------------------------------------------------------------------------
----------------------------------------------------------------------------------------------------------------------------------------------------------------------------------------------------------------
---------------------------------------------------------------------------------------------------------------------------------------------------------------------------------------------------------E------
----------------------------------------------------------------------------------------------------------------------------------------------------------------------------------------------------------------
----------------------------------------------------------------------------------------------------------------------------------------------------------------------------------------------------------------
----------------------------------------------------------XX---------------------------------------------------------------------------------------------------S-------------------X-----------------------XX---
---------------------------------------------------------XXX-------------------------------------------------XXXX---------------------------------------------------oo------------XX---------------------XXXX---
X-------------------------------------------------------XXXX---------------------------------------------------------------------------------------------------------------------XXX---------------------XXXX---
X------------------------------------------------------XXXXX---------------------------------------------------------------------------------------------------------------------XXX--------------------XXXXX---
X-------------------------------XX--------------------XXXXXX-------------------------------------XX---XXX----------------------------------------------------------------------X-XXX-------------------XXXXXX--S
X------------------------------XXX--XX---------------XXXXXXX------------------------------------XXX-E------------------------------------------------------------X------------XX-XXX---S-------------X-XXXXXX---
X-----------------------------XXXX------------------XXXXXXXX--------X--------------------------XXXX-------------------------------X------------------------------X------------XX-XXX----------------XX-XXXXXX---
X----------------------------XXXXX-----------------XXXXXXXXX--------X-------------------------XXXXX---------------------------E---X------------------------------X------------XX-XXX---------------XXX-XXXXXX---
X-----XXXXXXXXXXXXXXXXXX---XXXXXXX-----XXXXXXXXXXXXXXXXXXXXXXXXXXXXXXXXXXXXXXXXXXX--X-XXXX-XXXXXXXX----------------XXXXXXXXXXXXXXXXXXXXXXXXXXXXXXXXXXXXXXXXXXXXXXXXXXXXXXXXXXXXXXXXXXXXXXXXXXXXXXXXXXX-XXXXXXXXX