----------------------------------------------------------------------------------------------------------------------------------------------------------------------------------------------------------------
----------------------------------------------------------------------------------------------------------------------------------------------------------------------------------------------------------------
----------------------------------------------------------------------------------------------------------------------------------------------------------------------------------------------------------------
----------------------------------------------------------------------------------------------------------------------------------------------------------------------------------------------------------------
----------------------------------------------------------------------------------------------------------------------------------------------------------------------------------------------------------------
----------------------------------------------------------------------------------------------------------------------------------------------------------------------------------------------------------------
----------------------------------------------------------------------------------------------------------------------------------------------------------------------------------------------------------------
------------XX------------------------------------XX----------------------------------------------------------------------S----------------------------------E---XX---------------------------------------------
-------E---XXX------------------------------------XX-------------------------------------------------------------------------------------------------------------XX---------------------------------------------
-----------XXX------------------------------------XX------------------------------X------------------------------------------------------------------------------XX-------------------------X----------XSS------
---------X-XXX--------------------------------XX--XX----------------------------X-X---------------------------------------------------------------------------X--XX------------------------XX--------XXX--------
--------XX-XXX---S---------------------------XXX--XX----------Q--QQ-------------X-X--------------------------------------S-S----------------------------------X--XX----QQQ----------------XXX--------XXX--SS----
--------XX-XXX------------------------------XXXX--XX---------E--E------E------X-XXX--------------------------------------------------------E----------------X-X--XX----------------------XXXX-------XXXX--------
------X-XX-XXX-----------------------------XXXXX--XX------------------<>----E-X-XXX-------------------------------------------------------<>----------------X-X--XX---------------------XXXXX------XXXXX---SSS--
-----XX-XX-XXX----------------------------XXXXXX--XX------------------[]--------XXX------------------------------------E--E----------X----[]--------------X-X-X--XX--------------------XXXXXX----XXXXXXX--------
XX-XXXX-XX-XXXXXXXXXXXXXXXXXX-XXXXX---XXXXXXXXXX--XXXXXXXXXXXXXXXXXXXXXXXXXXXXXXXXXXXXXXXXXXXXXXXXXXXXXX-XXXXXXXXXXXXXXXXXXXXXXXXXXXXXXXXXXXXXXXXXXXXXX-XXX-X-X--XXXXXXXXXXXXXXXXXXXXXXXXXXXX--XXXXXXXXX------XX