----------------------------------------------------------------------------------------------------------------------------------------------------------------------------------------------------------------
----------------------------------------------------------------------------------------------------------------------------------------------------------------------------------------------------------------
----------------------------------------------------------------------------------------------------------------------------------------------------------------------------------------------------------------
----------------------------------------------------------------------------------------------------------------------------------------------------------------------------------------------------------------
----------------------------------------------------------------------------------------------------------------------------------------------------------------------------------------------------------------
----------------------------------------------------------------------------------------------------------------------------------------------------------------------------------------------------------------
----------------------------------------------------------------------------------------------------------------------------------------------------------------------------------EX----------------------------
--------------------XXX----------XX-----------------------------------------------------------------------------------------------------------------------------------------------XX----XX----------------------
---------------------------------XX----------------------------------------------------------------------------------------------------------------------------------------------XXXXX--------------------------
--------------------------------XXX---------------------------------------------------------------------------------------------------------------------------------------------XXXX----------------------------
-------------------------------XXXX------------------------------------------------------------------------------------------------------------------------E-------------------XXXXX----------------------------
XXX---------------------------XXXXX-----------------XXX----------------------XXXXXXX-------------XXX---XXX--------------------------------XX--XXXXXXXXXXXXXXXXXXXX-----------XXXXXXX----------------------------
-----------------------------XXXXXX---------------XXX-----------------------XX----------------------------------------------------------XXX------X---------------X----------XXXXXXXX-E--------------------------
----------------------------XXXXXXX-------------XX-------------------------XXX-------------XXX------------------------------------------XXX------X---------------X---------XXXXXXXXX<>--------------------------
----------------------------XXXXXXXXXXXXXXXXXXXXXX----------X-XXXXXXXXXXXXXXXX-------------X----------------------------------XXXXXXXXXXXXX------X---------------X---XXXXXXXXXXXXXXX[]--------------------------
----------------------------XXXXXXXXXXXXXXXXXXXXXX----------XXXXXXXXXXXXXXXXXX-------------X----------------------------------XXXXXXXXXXXXX------X---------------X---XXXXXXXXXXXXXXX[]--------------------------