----------------------------------------------------------------------------------------------------------------------------------------------------------------------------------------------------------------
----------------------------------------------------------------------------------------------------------------------------------------------------------------------------------------------------------------
----------------------------------------------------------------------------------------------------------------------------------------------------------------------------------------------------------------
----------------------------------------------------------------------------------------------------------------------------------------------------------------------------------------------------------------
----------------------------------------------------------------------------------------------------------------------------------------------------------------------------------------------------------------
----------------------------------------------------------------------------------------------------------------------------------------------------------------------------------------------------------------
---------------------------------------------------------------------------------------------------------------------------------------------------XX-----------------------------------------------------------
---------------------------XX------------------XX----------------------------------------------------------------------XX-------------------------XXX-----------------------------------------------------------
--------------------------XXX-----------------XXX---------------------------------------------------------------------XXX------------------------XXXX-----------------------------------------------------------
--------------XX---------XXXX----------------XXXX---------------------------------------------------------------------XXX-----------------------XXXXX-----------X-----------------------------------------------
--------------XX---------XXXX---------------XXXXX-------------------------------X-----------------------------------X-XXX-----------------------XXXXX----------XX--oo-------------------------------------------
------------XXXX-------X-XXXX--------------XXXXXX------------XXSSo-------------XX----------------------------------XX-XXX---------------------X-XXXXX---------XXX-----------------------------------------------
------------XXXX-------X-XXXX-------------XXXXXXX-----------XX----------------XXX----------------------------------XX-XXX---------X------E---XX-XXXXX--------XXXX-----------------------------------------------
------------XXXX-----X-X-XXXX------------XXXXXXXX----------XXX---------------XXXX----------------------------------XX-XXX---------X---------XXX-XXXXX-------XXXXX-----------------------------------------------
------------XXXX----XX-X-XXXX-----------XXXXXXXXX---------XXXX--------------XXXXX----------------------------------XX-XXX---------X--------XXXX-XXXXX------XXXXXXE----------------------------------------------
-X--------X-XXXXXX-XXX-X-XXXXXXXXXXXXXXXXXXXXXXXXXXXXXXXXXXXXXXXXXXXXXXXXXXXXXXXX-----XXXXXXXXXXXXXXXXXXXXXXXXXXXX-XX-XXXXXXXXXXXXXXXXXXXXXXXXX-XXXXXXXXXXXXXXXXXXXXXXXXXXX-X-X---XXXXXXXXXXXXXXXXXXXXXX-X---X--