----------------------------------------------------------------------------------------------------------------------------------------------------------------------------------------------------------------
----------------------------------------------------------------------------------------------------------------------------------------------------------------------------------------------------------------
----------------------------------------------------------------------------------------------------------------------------------------------------------------------------------------------------------------
------------------------------------------------------------------------------------------------------------------------------------------------------------------------------------------------------SSSSSSSSS-
----------------------------------------------------------------------------------------------------------------------------------------------------------------------------------------------------------------
--------------------------------------------------------------------------------------------------------------------------------------------------------------------------------------------E-------------------
-SSSSSSS-------------------------------------------------------XX------------------------------------------------------------XX------------------------SSSSSSSSSS------------------SSSSSSSSSSSSSSS--------------
--------------------------------------------------------------XXX-----------------------------------------------------------XXX----XX---------------------------------------------------------------------------
--------------------------------B----------------------------XXXX----------------------------------------------------------XXXXXX-------------------------------------------------------------------------------
--------------------------------b---------------------------XXXXX-----------------------B---X-----------------------------XXXXX----------------------------E----------------------------------------------------
-SSSSSSSS--X-------------------XXX--S----------------------XXXXXX----------------------XXXXXX-------------XX-------------XXXXXX-------------------------SSSSSSSSS-------------------------------?QX-------------
-----------XX-----------------XXXX------------------------XXXXXXX---------------------XXXXXXX------------XXX------------XXXXXXX-------------------------------------------------------------------X----------E--
----------XXXXX--------------XXXXX-----------------------XXXXXXXX--------------------XXXXXXXX-----------XXXX-----------XXXXXXXX-E-----------------------------------------------------------------X-------------
-----E----XXXXXX------------XXXXXX----------------------XXXXXXXXX-------------------XXXXXXXXX----------XXXXX----------XXXXXXXXX<>--------------------------E--------------------------------------X-------------
XXXXXXXXXXXXXXXXXX------S---XXXXXXXXXXXXXXXXXXXXXXXXXXXXXXXXXXXXXXX------------S---XXXXXXXXXXXXXXXXXXXXXXXXX---------XXXXXXXXXX[]-------------------XXXXXXXXXXXXXXX-XXXXXXXX---------------XXXXXXXXXXXXXXXXXXXXX
XXXXXXXXXXXXXXXXXX----------XXXXXXXXXXXXXXXXXXXXXXXXXXXXXXXXXXXXXXX------X---------XXXXXXXXXXXXXXXXXXXXXXXXX--XX--XX-XXXXXXXXXX[]-------------------XXXXXXXXXXXXXXX-XXXXXXXX---------------XXXXXXXXXXXXXXXXXXXXX