----------------------------------------------------------------------------------------------------------------------------------------------------------------------------------------------------------------
----------------------------------------------------------------------------------------------------------------------------------------------------------------------------------------------------------------
----------------------------------------------------------------------------------------------------------------------------------------------------------------------------------------------------------------
----------------------------------------------------------------------------------------------------------------------------------------------------------------------------------------------------------------
----------------------------------------------------------------------------------------------------------------------------------------------------------------------------------------------------------------
----------------------------------------------------------------------------------------------------------------------------------------------------------------------------------------------------------------
----------SSSSSS------------------------------------------------------------------------------------------------------X-----------------------XX-----------------------------------------------X----------------
--------------------------------------------------------------------------------------------------------X------------XX----------------------XXX----------------------------------------------XX----------------
--------------------------------------------------------------------------------------------------------------------XXX---------------------XXXX---------------------------------------------XXX----------------
--------EE---------------------------------------------------------------------------------------------------------XXXX--------------------XXXXX---------ooo--------------------------------XXXX----------------
----XX-XXX-SSSSS--------------------------------------------------------------------------------------------------XXXXX-----------X-------XXXXXX-------------------------------------------XXXXX----------------
----XXXXXX-------------------------------------------------------------------------------------------------------XXXXXX----------XX------XXXXXXX------------------------------------------XXXXXX----------------
----XXXXXX------------------------------------------------------------------------------------------------------XXXXXXX---------XXX-----XXXXXXXX-----------------------------------------XXXXXXX----------------
----XXXXXX------------------------------------E-----------------------X----------------------------------------XXXXXXXX--------XXXX----XXXXXXXXX-------XXXXXXXX-----------E-------------XXXXXXXX----------------
----XXXXXXXXXXXXXXXXX----XXXXXXXXXXXXXXXXXXXXXXXXXXXXXXXXXX---XXXXXXXXX---------------------------------XXXXXXXXXXXXXXX--------XXXXXXXXXXXXXXXXX-------X--------------XXXXXXXXX-XXXXXXXXXXXXXXXXXXXXXX----------
----XXXXXXXXXXXXXXXXX----XXXXXXXXXXXXXXXXXXXXXXXXXXXXXXXXXX---XXXXXXXXX---------------------------------XXXXXXXXXXXXXXXX-X-----XXXXXXXXXXXXXXXXX-------X--------------XXXXXXXXX-XXXXXXXXXXXXXXXXXXXXXX----------