----------------------------------------------------------------------------------------------------------------------------------------------------------------------------------------------------------------
----------------------------------------------------------------------------------------------------------------------------------------------------------------------------------------------------------------
----------------------------------------------------------------------------------------------------------------------------------------------------------------------------------------------------------------
---------------------------------------------------------------------------------------------------------------------------------------SSSSSSSSSSSSSSSSSSSS-----------------------------------------------------
----------------------------------------------------------------------------------------------------------------------------------------------------------------------------------------------------------------
----------------------------------------------------------------------------------------------------------------------------------------------------------------------------------------------------------------
-------------------------------------------------------------------XX------------------------------------------------------------------------------------------------------------------------------------XX-----
------------------------------------------------------------------XXX---------------------------------------------------------------------------------------------------------XX-----------XX-----------XXX-----
-----------------------------------------------------------------XXXX--------------------------------------------------------------------------------------------------------XXX-----------------------XXXX-----
-------------------------------------------X--------------------XXXXX----------------------------------------------------------X-------XXXX---------------------------------XXXX----------------------XXXXX-----
------------------------------------------XX-------------------XXXXXX---------------------------------------------------------XX------XXXXX-------------------------------X-XXXX---------------------XXXXXX-----
-XXXXXXXXXXXXX---------------------------XXX------------------XXXXXXX--------------------------------------------------------XXX-----XXXXXX----------------------------X--X-XXXX--------------------XXXXXXX---S-
XXX-------------------------------------XXXX-----------------XXXXXXXX-------------------------------------------------------XXXX-----XXXXXX----------------------------X--X-XXXX-------------------XXXXXXXX-----
XXX------------------------------------XXXXX----------------XXXXXXXXX------------------------------------------------------XXXXX----XXXXXXX------------------X-------XXX--X-XXXX------------------XXXXXXXXX-----
XXX-----------------------------------XXXXXX---------------XXXXXXXXXX-----------------------------------------------------XXXXXXE---XXXXXXX--XXXXXXXXXXXXXXXXX------XXXX--X-XXXX-----------------XXXXXXXXXX-----
XXX----------------------------------XXXXXXXXXXXXXXXXXXXXXXXXXXXXXXXXXXXXXXXXXXXXX-XXXXXXXXXXXXXXX--XXXXXXXXXXXXXXXXXXXXXXXXXXXXXXXXXXXXXXX--XXXXXXXXXXXXXXXXX------XXXX--X-XXXX--------------XXXXXXXXXXXXXXXXXX