----------------------------------------------------------------------------------------------------------------------------------------------------------------------------------------------------------------
----------------------------------------------------------------------------------------------------------------------------------------------------------------------------------------------------------------
----------------------------------------------------------------------------------------------------------------------------------------------------------------------------------------------------------------
----------------------------------------------------------------------------------------------------------------------------------------------------------------------------------------------------------------
----------------------------------------------------------------------------------------------------------------------------------------------------------------------------------------------------------------
----------------------------------------------------------------------------------------------------------------------------------------------------------------------------------------------------------------
----------------------------------------------------------------------------------------------------------------------------------------------------------------------------------------------------------------
-------------------XX---------------------XX-----------------------------------------------------------XX-------XX----------------------XX----------------------------------------------------------------------
------------------XXX---------------------XX----------------------------------------------------------XXX------XXX---------------------XXX----------------------------------------------------------------------
------------------XXX----------X----------XX---------------------------------------------------------XXXX-----XXXX---------XX---------XXXX---------------------------------X------------------------------------
----------------X-XXX---------XX--------X-XX---------------------------------------------------------XXXX----XXXXX--------XXX---------XXXX--------------------------------XX------------------XXXX--------------
---------------XX-XXX--------XXX-------XX-XX-------------------------------------------------------X-XXXX---XXXXXX-------XXXX-------X-XXXX-------------------------------XXX------------------------------------
---------------XX-XXX--------XXX-------XX-XX--------------------------------------------------E---XX-XXXX--XXXXXXX-------XXXX-------X-XXXX----------------------------X-XXXX------------------------------------
-------------X-XX-XXX-------XXXX-------XX-XX-----------------------------------------------------XXX-XXXX-XXXXXXXX-------XXXX------XX-XXXX----------------------------X-XXXX----------------X-------------------
------------XX-XX-XXX------XXXXX----X--X--XX--------X-------------------------------------------XXXX-XXXXXXXXXXXXX-------XXXX----X-XX-XXXX----------------------------X-XXXX------------XXXXX-------------------
XXXXXXXX-XXXXX-XX-XXXXXXXXXXXXXXX-XXX--XX-XXXXXXXXXXXXXXXXXXXXXXXXX-XXXXXXXXXXXXXXXXXXXXXXXXXXXXXXXX-XXXXXXXXXXXXXXXXXXXXXXXX--X-X-XX-XXXXXXXXXXXXXXXXXXXXXXXXXXXXXX--XXXXXXXXXXXXXXXXXXXXXXX-------------------