----------------------------------------------------------------------------------------------------------------------------------------------------------------------------------------------------------------
----------------------------------------------------------------------------------------------------------------------------------------------------------------------------------------------------------------
----------------------------------------------------------------------------------------------------------------------------------------------------------------------------------------------------------------
--------------------SSSSSSSSSSSSSSSSSSSSSSSSSSSSSSSSSSSSSSSSSSS----------SSSSSSSSSSSSSSSSSSSSSSSSSSSSSSSSSSSSSSSSSSSSSSSSSSSSSSSSSSSSSSSSSSSS-------------------------------------------------------------------
------------------------------------------SSSSSSSSSSSS----------------------------------------------------------------------------------------------------------------------------------------------------------
------------------------------------------SSSSSSSSSSSS----------------------------------------------------------------------------------------------------------------------------------------------------------
-----------------------------------------SSSSSSSSSSSSS----------------------------------------------------------------------------------------------------------------X---------------------------------------XX
---------------------SSSSS--------------------------------------------------------------------------------------------------------------------------------------------------------------------------------------
---------------------SSSSS--------------------------------------------------------------------------------------------------------------------------------------------------------------------------------------
--------------------oSSSS------------------------------------------------------------------------------XXXX---------------------------XXXX-----------------------------------------------------------------X----
--------------------SSSSS---------------S-SSSSSS------------------------------------------------------XXXXX------------X-----------------------------------------XXX--------------------------------------XX----
-------------------------------------E-----------XXX----------------------------------XXXX-----------XXXXXX----------------------------------------------------------------------------------------------XXX----
------------------------------------<>----------XXXX----------------------------XX------------------XXXXXXX---------------------------------------------------------------------------------------------XXXX----
------------------------------------[]---------XXXXX-----------------------------------------------XXXXXXXX-------X-------------------------------------------X----------------------------------------XXXXX----
-------------------XXXXXXXXXXXXXXXXXXXXXXXXXXXXXXXXXXXXXXXXXXXXXXXXXXXXXXXXXXX---------------------XXXXXXXX-XXXXXXX---------------------------XXXXXXXXXXXXXXXXX------------------XXXXXXXXXXXXXXXXXXXXXXXXXXX----
-------------------XXXXXXXXXXXXXXXXXXXXXXXXXXXXXXXXXXXXXXXXXXXXXXXXXXXXXXXXXXX---------------------XXXXXXXX-XXXXXXX---------------------------XXXXXXXXXXXXXXXXX------------------X-XXXXXXXXXXXXXXXXXXXXXXXXX----