----------------------------------------------------------------------------------------------------------------------------------------------------------------------------------------------------------------
----------------------------------------------------------------------------------------------------------------------------------------------------------------------------------------------------------------
----------------------------------------------------------------------------------------------------------------------------------------------------------------------------------------------------------------
---------------------------------------------------------------------SSSSSSSSSSSSSSSSSSSSSSSSSS-----------------------------------------------------------------------------S-SSSSSSSS-------SSSSSSSSSSSSSSSSSSS
-----------------------------------------------------------------------------------------------------------------------------------------------SSSSSSSSSSSSSSSSSSSSSSSS-----------------------------------------
----------------------------------------------------------------------------------------------------------------------------------------------------------------------------------------------------------------
-------------------------------------------------------------------XX-------------------------------------------------------------------------------------------------------------------------------------------
-----------------------------------------------SSSQ---------------XXX-------------------------------------------------------------------------------------------------------------------------------------------
-----------------------------------------------------------------XXXX-------------------------------------------------------------------------------------------------------------------------------------------
----------------------------------------------------------------XXXXX---------------------X--------------------------------------------------------------------------------------------------XXXXX--------------
---------------------------------------------------------------XXXXXX-----------------------------------------------------------------------------------------------------------------------XXXXXX--------------
--------------------------------------XX------SSSSS-----------XXXXXXX--------------------------------XX----------------------------------------------------XX--X---------------------------XXXXXXX-----------XXX
-------------------------------------XXX---------------------XXXXXXXX---XXX-------------------------XXX--------------------------------------------------EXXX--XX-------------------------XXXXXXXX--XXXX--------
------------------------------------XXXXX-------------------XXXXXXXXX------------------------------XXXXX-------------------------------------------------XXXX--XX--------------X---------XXXXXXXXX--------------
-----------------------------------XXXXXX------------------XXXXXXXXXX-----------------------------XXXXXX----------------------------------------------E-XXXXX--XXX-----------XXX--------XXXXXXXXXX--------------
XXXXXXXXXXXX-X--XXXXXXXXXXXXXXXXXXXXXXXXXXXXXXXXXXXXXXXXXXXXXXXXXXXXXXX---------------------------XXXXXX---------------XXXXXXXXXXXXXX-XXXX-X---XXXXXXXXXXXXXXXXXXXXXXXXXXXXXXXXX--------XXXXXXXXXXX-------X-----