----------------------------------------------------------------------------------------------------------------------------------------------------------------------------------------------------------------
----------------------------------------------------------------------------------------------------------------------------------------------------------------------------------------------------------------
----------------------------------------------------------------------------------------------------------------------------------------------------------------------------------------------------------------
----------------------------------------------------------------------------------------------------------------------------------------------------------------------------------------------------------------
----------------------------------------------------------------------------------------------------------------------------------------------------------------------------------------------------------------
----------------------------------------------------------------------------------------------------------------------------------------------------------------------------------------------------------------
----XX----------------------------------------------------------------------------------------------------------XX-------------X-------------------------------------------------------------------------------E
---XXX----------------------------------------------------------------------------------------------------------XX------------XX-------------------------------------------------------------------------------X
--XXXX--------------------------------------------------------------------------------------------------------X-XX-----------XXX------------------------------------------------------------------------------XX
-XXXXX--------------------------------------------------------------------------------------------------------X-XX----------XXXX-----------------------------------------------------------------------------XXX
XXXXXX----------------------------X--------------------------------------------------XX--------------------X--X-XX---------XXXXX----------------------------------------------------------------------------XXXX
XXXXXX----------------------------XX------------------------------------------------XXX--------------------X--X-XX--------XXXXXX----------------------------------------------------------------E----------XXXXX
XXXXXX----------------------------XXX----------------------------------------------XXXX--------------------X--XXXX-------XXXXXXX---------------------------------------------------------------<>---------XXXXXX
XXXXXX----------------------X-----XXXX------------------X-------------------------XXXXX-----------X-----X--X--XXXX------XXXXXXXX---------------------------------------------------------------[]--------XXXXXXX
XXXXXX-------XXXXXXXXXXXXXXXX-----XXXXXXXXXXXXXXXXXXXXXXX------------------------XXXXXXXXXXXXXXXXXX-----XX-X--XXXXXXXXXXXXXXXXXXXXXXXXXXXXXXXXXXXXXXXXXXXXXX---XXXXXXXXXXXXX-----XXXXXXXXXXXXXXXXXXXXXXXXXXXXXXX
XXXXXX-------XXXXXXXXXXXXXXXX-----XXXXXXXXXXXXXXXXXXXXXXX------------------------XXXXXXXXXXXXXXXXXX-----XX-X--XXXXXXXXXXXXXXXXXXXXXXXXXXXXXXXXXXXXXXXXXXXXXX---XXXXXXXXXXXXX-----XXXXXXXXXXXXXXXXXXXXXXXXXXXXXXX