----------------------------------------------------------------------------------------------------------------------------------------------------------------------------------------------------------------
----------------------------------------------------------------------------------------------------------------------------------------------------------------------------------------------------------------
----------------------------------------------------------------------------------------------------------------------------------------------------------------------------------------------------------------
SSSSSSSSSSSSSSSSSSSSSSSSSSSSSSSSSSSSSSSSSSS---------------------------------------------------------------------------------------------------------------------------------------------------------------------
-------------------------------------------------------------------------------------------------------------------------------------------------------------------------------------------------SSSSSSSSSS-----
--------------------------------------------------------------------------------------------E----------------------------------------------------------------------------------------------------SSSSSSSSS------
-----------------------------------------------------------------------------------------SSSSSSSSSSSSSSS----------------------------------------------------------XX-----------------------------SSSSSSSS-------
------------------------------------------------------------------------------------------------------------------------------------------------------------------XX-----------------------------SS-S----E------
-----------------------------------------------------------------------------------------------------------------------------------------------------------------XXX--------------------------------------------
------------------------------------------------------------------------------------------------E---------------X-X---------------------------------------------XXXX--------------------------------------------
-------------------------------------------------------------------XXXXXXXXX---------------------SSSSSSS-----X--XXX---------------------------------------------XXXX--------------------------------------X-----
-------------------------XXX------XXX-------------------------------------------------------X---------------XX--XXX---------------------------------------------XXXX-------------------------------------XX--X--
-----------------------------------------------------------------------------------------------------------XXX--XXX------------------------------------------X--XXXX------------------------------------XXX--XX-
----------------------------------------------------------------------------------------------------------XXXX--XXX----------------------------------------X-X--XXXX-----------------------------------XXXX--XXX
------XXX--------XXXXXX-----------------------------XXXXXXXXXX--------------------------XXXXXXXXXXXXXXXXXXXXXX--XXXXXXXXXXXXXXXXXXXX------------------XXXXXX-X--XXXX----------------------------XXXXXXXXXXX--XXX
-XX---XXX--------XXXXXX-----------------------------XXXXXXXXXX--------------------------XXXXXXXXXXXXXXXXXXXXXX--XXXXXXXXXXXXXXXXXXXX------------------XXXXXX-X--XXXX----------------------------XXXXXXXXXXX--XXX