----------------------------------------------------------------------------------------------------------------------------------------------------------------------------------------------------------------
----------------------------------------------------------------------------------------------------------------------------------------------------------------------------------------------------------------
----------------------------------------------------------------------------------------------------------------------------------------------------------------------------------------------------------------
----------------------------------------------------------------------------------------------------------------------------------------------------------------------------------------------------------------
----------------------------------------------------------------------------------------------------------------------------------------------------------------------------------------------------------------
----------------------------------------------------------------------------------------------------------------------------------------------------------------------------------------------------------------
---------------------------------------------------------------------------------------------------------------------------------------------------------------------------------------------------------X------
---------------------------XX--------------------------XX-----X--------------------------------------------------------------------XX----------XX----XX-------------------------------------------------XXX-----
------------------------------------------------------XXX-X------------------------------------------------------------------------XX---------XXXXX------------------------------------------------E---XXX------
-----------------------------------------------------XXXX--------------------------------------------------------------------------XX---------XXX------------------------------------------------------XXXX-----
-------------XXX------------------------X------------XXXX-------XXX--------------------------------------------XXXXXX-----------X--XX-------X-XXX----------------------------------------------------X-XXXX-----
---------------------------------------XX----------X-XXXX-------XXX-------------------------------------------------------------X--XX-------X-XXX---------------------------------------------------XX-XXXX-----
--------------------------------------XXX---------XX-XXXX--E----XXX-----------------------------------------------------------X-X--XX-------X-XXX---------------------------------------------------XX-XXXX-----
-------------------------------------XXXX--------XXX-XXXX-<>----XXX---------------------------------XX----XXXX---------------XX-X--XX-------X-XXXX------------------------------------------------X-XX-XXXX-----
------------------------------------XXXXX-------XXXX-XXXX-[]----XXXXXXXXX----------------------XXXXXXX----------------------XXX-X--XX-------X-XXXXX------------XXXX------------------------------XX-XX-XXXX-----
----------------------------------XXXXXXX------XXXXX-XXXX-[]----XXX----------------------------XXXXXXX--------------------XXXXX-X--XXXXXX---X-XXXXX---------------------------------XXXXXXXXXXXXXXX-XX-XXXXXXXXX