------------------------------------------------------------------------------------------------------------------------------------------------------------------------
------------------------------------------------------------------------------------------------------------------------------------------------------------------------
------------------------------------------------------------------------------------------------------------------------------------------------------------------------
------------------------------------------------------------------------------------------------------------------------------------------------------------------------
------------------------------------------------------------------------------------------------------------------------------------------------------------------------
---------------------------------------------SSS?SDS-S-S-SSSSSSSSSS----------------------------------------------SSSSSDS------------------------------------------------
------------------------------------------------------------------------------------------------------------------------------------------------------------------------
-------------------------------------------E----E-----------------------------------------------------------------------------------------------------------------------
------------------------------------------------------------------------------------------------------------------------------------------------------------------------
----SSSDS--D-------XXX---X------SSSDS-----<>---?S--XS-------SS-------------------------------------------XX---XX-------------------------------------------------D------
---------------->--XX---XXX---------------[]-------X-------------------------------------------------XX--X----X----------------[-------X--------------------]-----------
---------------<>--XX--XXXX---------------[]-------XX-----------------------------------------------XXXXXX---XXX---------------[-------XX-------------------<--------<>-
-X-E-----------[]--XX--XXXX--E-E-E--------[]-------EX-----------------------------------------------XXXXX----XXX---------------[]-E----XX---------------E---[--------[]-
XXXXXXXXXXXXXXXXXXXXXXXXXXXXXXXXXXXXXXXXXXXXXXXXXXXXXXXXXXXXXXXXXXXXXXXXXXXXXXXXXXXXXXXXXX----------XXXXXXX-XXXXXXXXXXXXXXXXXXXXXXXXXXXXXXXXXXXXXXXXXXXXXXXXXXXXXXXXXXXX