------------------------------------------------------------------------------------------------------------------------------------------------------------------------
------------------------------------------------------------------------------------------------------------------------------------------------------------------------
------------------------------------------------------------------------------------------------------------------------------------------------------------------------
------------------------------------------------------------------------------------------------------------------------------------------------------------------------
------------------------------------------------------------------------------------------------------------------------------------------------------------------------
---?S---------------------------------------------------SSSSSSSS------------------S----SSSD----------------------SSSSSDSSDS-----SSSS------------------------------------
------------------------------------------------------------------------------------------------------------------------------------------------------------------------
--------------------------------------------------------------------------------------E---------------------------------------------------------------------------------
------------------------------------------------------------------------------------------------------------------------------------------------------------------------
-----D---S--D--------XX--XXX----------------------X---XX------------D------S-S-------?S------S?-D----X------------------------S--------XX--------------D--D-------------
--------------------XXX-XXXX---------------------XX---XX--------------->-----------------------------X---------------------------------X--------------------------------
X---------------<>-XXX--XXXX--------------------XXX---XX--------------<>----------------------------[XX--------------------------------XX-------------------------------
[----E----E-E---[]XXX-X-XXXX-------------------XXXX--XXX---------EE---[]--E-------E-------E---E-----XXX------E-X-----------------------XX-------------------------------
XXXXXXXXXXXXXXXXXXXXXXXXXXXXXXXXXXXXXXXXXXXXXXXXXXXXXXXXXXXXXXXXXXXXXXXXXXXXXXXXXXXXXXXXXXXXXXXXXXXXXXXXXXXXXXXXXXXXXXXXXXXXXXXXXXXXXXXXXXXXXXXXXXXXXXXXXXXXXXXXXXXXXXXX