------------------------------------------------------------------------------------------------------------------------------------------------------------------------
------------------------------------------------------------------------------------------------------------------------------------------------------------------------
---------------------------------------------------------------XX-------------------------------------------------------------------------------------------------------
--------------------------------------------------------------XXXX------------------------------------------------------------------------------------------------------
--------------------------------------------------------------XXXX------------------------------------------------------------------------------------------------------
----S----------------------------------------------------------XXXXX----------SSSSSS------------------------------------------------------------------------------SSSS--
------------------------------------------------------------------------------------------------------------------------------------------------------------------------
-----------------------------------------------------------------------------E------------------------------------------------------------------------------------------
------------------------------------------------------------------------------------------------------------------------------------------------------------------------
-DS------S------------------------------------XX-XXX--XX-DS-----------SS---SSS-----------------------<>----XX----------------------S?S----------------------------------
---------------------------------------------XX--XX---XX---------------------------------------------[]--XX----X-------------------------------------------------------X
---------------------------------------------XXXXXX---XX---------------------------------------------[]--XX-XXXX-------------------------------------------------------X
--------------------------------------------XXXXXXX--XXX--------E--------------------------------E---[]-XXX-XXXX--------------[-----------E----------------------------X
XXXX-XXXX--XXXXXXXXXXXXXXXXXXXX----X---------XXXXXX-XXXXXXXXXXXXXXXXXXXXXXXXXXXXXXXXXXXXXXXXX--XXXXXXXXXXXXXXXXXXXXXXXX--XXXXXXXXXXXXXXXXXXXXXXXX--------------------XXX