------------------------------------------------------------------------------------------------------------------------------------------------------------------------
------------------------------------------------------------------------------------------------------------------------------------------------------------------------
------------------------------------------------------------------------------------------------------------------------------------------------------------------------
------------------------------------------------------------------------------------------------------------------------------------------------------------------------
------------------------------------------------------------------------------------------------------------------------------------------------------------------------
-----------------------------------------------------------SSSD---------------------------------------------------------------------------------------------------------
------------------------------------------------------------------------------------------------------------------------------------------------------------------------
------------------------------------------------------------------------------------------------------------------------------------------------------------------------
------------------------------------------------------------------------------------------------------------------------------------------------------------------------
----SSS----D-------S-S----------SSSDS--D--DS----SSS---------SD--D-------<>---D--------------------S-------XXX--------D--D-------------S--------------S------------XX----
----------------]-------------------------------------------------------[]--------------------------------XXX---->------------------------------------------------XX----
---------------[]--------<>---------------------------------------------[]-------<------------------------XXX---<>--------------------------------------------X---XXX---
---------------[]-E------[]------------------------------E-E-E-----EE---[]-------[]---------------[]-----XXXX--E[]-E-E----------------------------------------XX-XXXX---
XXXXXXXXXXXXXXXXXXXXXXXXXXXXXXXXXXXXXXXXXXXXXXXXXXXXXXXXXXXXXXXXXXXXXXXXXXXXXXXXXXXXXXXXXXXXXXXXXXXXXXXXXXXXXXXXXXXXXXXXXXXXXXXXXXXXXXXXXXXXXXX----XX----XXXXXXXXXXXXXXX