------------------------------------------------------------------------------------------------------------------------------------------------------------------------
------------------------------------------------------------------------------------------------------------------------------------------------------------------------
------------------------------------X-----------------------------------------------------------------------------------------------------------------------------------
-----------------------------------XX-----------------------------------------------------------------------------------------------------------------------------------
-----------------------------------XX-----------------------------------------------------------------------------------------------------------------------------------
----------------------SSS---SS----SSSXX------------SSS-S-----------------------------SSSSSSS------------------------------------------SS---------SS---------------------
------------------------------------------------------------------------------------------------------------------------------------------------------------------------
------------------------------------------------------------------------------------------------------------------------------------------------------------------------
------------------------------------------------------------------------------------------------------------------------------------------------------------------------
-----------------------------------------------S------------SSSDS------------------------S-------------XX-X-X----------------------X------------------------<>----------
------------------------------------------------------------------------<>-----------------------------XX--XXX---------------------X---X--------------------[]----------
------------------------------------------<>----------------------------[]-------<>----------------<>-XXX-XXXX----------------<>--X----X--------------------[]-------<>-
------------------------------------------[]----------------------------[]-------[]----------------[]XXXX-XXXX-----------------]-XXX--XXX------------E-E----[]-------[]-
-----------------------XXXXX----XX--------XXXXXXXXXXXXXXXXXXXXXXXXXXXXXXXXXXXXXXXXXXXXXXXXXXXXXXXXXXXXXXXXXXXXXXXXXXXX---XXXXXXXXXXXXXXXXXXXXXXXXXXXXXXXXXXXXXXXXXXXXXXX