------------------------------------------------------------------------------------------------------------------------------------------------------------------------
------------------------------------------------------------------------------------------------------------------------------------------------------------------------
------------------------------------------------------------------------------------------------------------------------------------------------------------------------
------------------------------------------------------------------------------------------------------------------------------------------------------------------------
------------------------------------------------------------------------------------------------------------------------------------------------------------------------
-----------------------SSSSS-SSSSSSS--------------------SSSSSSSSSD---------------------?S-----------------------S-------------------------------SSSS--------------------
------------------------------------------------------------------------------------------------------------------------------------------------------------------------
------------------------------------------------------------------------------------------------------------------------------------------------------------------------
------------------------------------------------------------------------------------------------------------------------------------------------------------------------
--D----------------S------------------?-D-------XX--XX-----------------------XX----X-----D---------<>-----S-X--------------------------------DS------S?--------S-S------
-----------------------------------------------XXX--XX---------------------XXXX--XXX->-------------[]-------X-----------------------------------------------------------
--------------<]---------------------------<>--XXX-XXXX----------------<>-XXXXXXXXXX<>-------------[]-------X---------------------------------------------<>------------
---------EE---[]----------------------E-E--[]-XXXXXXXXX-----------------XXXXXXXXXXXX[]---E----E-E--[]-E-----XEXE---------------------------X----------E---[]------------
XXXXXXXXXXXXXXXXXXXXXXXXXXXXXXXXXXXXXXXXXXXXXXXXXXXXXXXXXXXXXXX--XXXXXXXXXXXXXXXXXXXXXXXXXXXXXXXXXXXXXXXXXXXXXXXXXXXXX---XXX---XXXXXX--XXXXXXXXXXXXXXXXXXXXXXXXXXXXXXXXX