------------------------------------------------------------------------------------------------------------------------------------------------------------------------
------------------------------------------------------------------------------------------------------------------------------------------------------------------------
------------------------------------------------------------------------------------------------------------------------------------------------------------------------
------------------------------------------------------------------------------------------------------------------------------------------------------------------------
------------------------------------------------------------------------------------------------------------------------------------------------------------------------
-SSSSSSS----------------------SSSSD----------------------------------------------------------------------------------------------S--------------------------------------
------------------------------------------------------------------------------------------------------------------------------------------------------------------------
------------------------------------------------------------------------------------------------------------------------------------------------------------------------
------------------------------------------------------------------------------------------------------------------------------------------------------------------------
----SS---------<>---S-SS-------------------------------------DS-D-------------S----------D---S---------X-XXXXXXX---------------------XXXXX-------D--D-----SS------S?S---
--------------[[]-------------------------------------------------------[------------>----------------XXXXXXXXXX------------------X-XXXXXX-X-----------------------X----
--------------[[]--------------------------<>XX-------------------------[]----------<>--------------XXXXXXXXXXXX-----------------XXXXXXXXXXX<>---------------------X----
-E-------E-----[]-E-------E----------------[XXX---------[]-E-E----------[]----------[]---E----E-----XXXXXXXXXXXX-----------------XXXXXXXXXXX[]-E-E-----------------XX---
XXXXXXXXXXXXXXXXXXXXXXXXXXXXXXXXXXX--XXXXXXXXXXXXXXXXXXXXXXXXXXXXXXXXXXXXXXXXXXXXXXXXXXXXXXXXXXXXXXXXXXXXXXXXXXXXXXX---XX--XXXXXXXXXXXXXXXXXXXXXXXXXXXXXXXXXXXXXXXXXXXXX