------------------------------------------------------------------------------------------------------------------------------------------------------------------------
------------------------------------------------------------------------------------------------------------------------------------------------------------------------
------------------------------------------------------------------------------------------------------------------------------------------------------------------------
------------------------------------------------------------------------------------------------------------------------------------------------------------------------
------------------------------------------------------------------------------------------------------------------------------------------------------------------------
SS---SSS--------------------------------------SS--D-----------------------------------------------------?SDSSSSS--SDSSDS-----------------------SS?D---------------------
------------------------------------------------------------------------------------------------------------------------------------------------------------------------
----------------------------------------------------------------------------------------------------------------------------------------------E-------------------------
------------------------------------------------------------------------------------------------------------------------------------------------------------------------
------------------------------------S--D--DS-----------------------D-------XXXX---XX----SSSDS-----<>---SS--S---S----SSS-S------X---S--D------?S--D--D-D-----<----X--XX-X
--------------------------------------------------------------------------XXXXX--XXX--------------[]-------------------------->>>---------------------------[]--XX--XXXX
--------------<>--------------------------------------------------------XXXXXX---XXX--------------[]--------------------------[[]---------------------------[>-XXX--XXXX
--------------[]------------------------------------EEEE---------------XXXXXX-X-XXXX-E-E-E------E-[]-------------E-E-E--------[[]-E----------E-E-E-----E----[]-XXX--XXXX
XXXXXXX--XXXXXXXXXXXXXXXXXXXXXXXXXXXXXXXXXXXXXXXXXXXXXXXXXXXXXXXXXXXXXXXXXXXXXXXXXXXXXXXXXXXXXXXXXXXXXXXXXXXXXXXXXXXXXXXXXXXXXXXXXXXXXXXXXXXXXXXXXXXXXXXXXXXXXXXXXXXXXXX