------------------------------------------------------------------------------------------------------------------------------------------------------------------------
------------------------------------------------------------------------------------------------------------------------------------------------------------------------
------------------------------------------------------------------------------------------------------------------------------------------------------------------------
------------------------------------------------------------------------------------------------------------------------------------------------------------------------
------------------------------------------------------------------------------------------------------------------------------------------------------------------------
---?-----------------SSS---S----------------------------SSSSXSSSSD-------------------SSSSSSSSD-D-------------------SSDD-------------------------------------------SSSS--
------------------------------------------------------------------------------------------------------------------------------------------------------------------------
------------------------------------------------------------------------------------------------------------------E-----------------------------------------------------
------------------------------------------------------------------------------------------------------------------------------------------------------------------------
----SDS-D------<-------XX---------------------------X----?S----------------XXX--XX----S--S------------------------S--D--DS-----<>-----S------------------------S--------
-----------------------XX-------------------[---------------------------<--XX---XX------------------<------------>-------------[]---------------------------------------
----------------------XXX-------------------[]-------XX-----------------<>-XX--XXX-----------------[<--------X--[]-------------[]-------------------------<>------------
[E-E-E------E--------XXXX------------E-E----[]-------XXX--------E--E----[]-XX-XXXX-----------------[[]------XXX-[]-E-E------E--[]-------------------------[]------------
XXXXXXXXXXXXXXXXXXXXXXXXXXXXXXXXXXXXXXXXXXXXXXXXXXXXXXXXXXXXXXXXXXXXXXXXXXXXXXXXXXXXXXXXXXXXXXXXXXXXXXXXXXXXXXXXXXXXXXXXXXXXXXXXXXXXXXXXXXXX---------------XXXXXXXXXXXXX