------------------------------------------------------------------------------------------------------------------------------------------------------------------------
------------------------------------------------------------------------------------------------------------------------------------------------------------------------
------------------------------------------------------------------------------------------------------------------------------------------------------------------------
------------------------------------------------------------------------------------------------------------------------------------------------------------------------
------------------------------------------------------------------------------------------------------------------------------------------------------------------------
----------------------------S------S--------------SSS-------S---------------?SSSSSSS----------------SSSS------------S-----------------------SSS--SSSSD------------------
------------------------------------------------------------------------------------------------------------------------------------------------------------------------
---------------------------------------------------------------------------------------------------E--------------------------------------------------------------------
------------------------------------------------------------------------------------------------------------------------------------------------------------------------
---------------------------------------D-------S-------------D---S?------------SS-----------------DS---------------------------<>-------XX----D---------------XX--------
-----------------------XX------------------------------------------------------------------------------------------------------[]---X--XXX-------------------XXX--------
---------------<>-XXX-XXX-------------------------------X>------------[]--------------------------------------------------------<---XXXXXXXX-----------------XX----XX---
---------------[]XXXX-XXXX------------------------------[---------E-E-[E--------E------------------------------E----------------[--XXXXXXXXX---------------XXXXX--XXX---
XXXXXXXXXXXXXXXXXXXXXXXXXXXXXXXXXX---XXXXXXXXXXXXXXXXXXXXXXXXXXXXXXXXXXXXXXXXXXXXXXXXXX---------XXXXXXXXX----XXXXXXXXXXXXXXXXXXXXXXXXXXXXXXXXXXXXXX-----XXXXXXXXXXXXXXXX