------------------------------------------------------------------------------------------------------------------------------------------------------------------------
------------------------------------------------------------------------------------------------------------------------------------------------------------------------
------------------------------------------------------------------------------------------------------------------------------------------------------------------------
-------------------------------------------------------------------------------------------XX---------------------------------------------------------------------------
-------------------------------------------------------------------------------------------XX---------------------------------------------------------------------------
SSSSSSSSS----------------------SSSD-----------------SSSS---D-------------------------------XXX------------SSSS-S-------------------------------?S?----------------------
------------------------------------------------------------------------------------------------------------------------------------------------------------------------
----------------------------------------------------------------------------------------------------------------------------------------------E-------------------------
------------------------------------------------------------------------------------------------------------------------------------------------------------------------
------------D-------XX--XX-X-?S-SS--------->---SD-----------SDS---------<>----SS---------------------<>--------------D--D------S>----------------D---S?-D--------XX--XXX
-------------------XXX--XXX----------------]----------------------------[]---------------------------[]-------------------------]------------>--------------<X---XX--XXX
---------------<>-XXXX-XXXXX--------------[]----------------------------[]---------------------------[]---------<>--------------<-----------<]--------------[X-XXX---XXX
----------E----[]XXXXXXXXXXX--------E-E---[]------------[E-E-E---E-EE---[]-------------------------E-[]---------[]-E-E------E---[--------EXX[]---E----E-E---[]-XXX--XXXX
XXXXXXXXXXXXXXXXXXXXXXXXXXXXXXXXXXXXXXXXXXXXXXXXXXXXXXXXXXXXXXXXXXXXXXXXXXXXXXXXXXXXXXXXXXX-----XXXXXXXXXXXXXXXXXXXXXXXXXXXXXXXXXXXXXXXXXXXXXXXXXXXXXXXXXXXXXXXXXXXXXXXX