------------------------------------------------------------------------------------------------------------------------------------------------------------------------
------------------------------------------------------------------------------------------------------------------------------------------------------------------------
-----------------------------------------------------------------------------------------------------------------------XX-----------------------------------------------
-----------------------------------------------------------------------------------------------------------------------XXX----------------------------------------------
-----------------------------------------------------------------------------------------------------------------------XXX----------------------------------------------
---------------------------------------------S---------------------------------------------------------------------SSSDXXXX-----------SSSS-S--------------------------S-
------------------------------------------------------------------------------------------------------------------------------------------------------------------------
------------------------------------------------------------------------------------------------------------------------------------------------------------------------
------------------------------------------------------------------------------------------------------------------------------------------------------------------------
-------------------XXXX---XX-------------------X-XXXXX------SS-D---D---------------------------D--D--------------DS---------------------------------------D----S?S------
------------------XXX-----X-------------------XXXXXXXX------------------------------------------------------------------------------------------------------------------
---------------<>XXXX----[XX-----------------XXXXXXXXXX----------------<>----------------------------<>-----------------------------------------------------------------
---------------XXXXXX----[]X-----------------XXXXXXXXXXX----------------]----------------------------[]--------E------E-E------E--------------------------------------E-
X--------X-----XXXXXXXX-XXXXXXXXXXXXX---XXXXXXXXXXXXXXXXXXXXXXXXXXXXXXXXXXXXXXXXXXXXXXXXXXXX--XXXXXXXXXXXXXXXXXXXXXXXXXXX---XXXXXXXXXXXXXXXXXXXXXXX--XXXXXXXXXXXXXXXXXXX