------------------------------------------------------------------------------------------------------------------------------------------------------------------------
------------------------------------------------------------------------------------------------------------------------------------------------------------------------
------------------------------------------------------------------------------------------------------------------------------------------------------------------------
------------------------------------------------------------------------------------------------------------------------------------------------------------------------
------------------------------------------------------------------------------------------------------------------------------------------------------------------------
-SSSSSSS------------------------------------------------------------------------------------------------------------------------------------SS---SSS--------------------
------------------------------------------------------------------------------------------------------------------------------------------------------------------------
------------------------------------------------------------------------------------------------------------------------------------------------------------------------
------------------------------------------------------------------------------------------------------------------------------------------------------------------------
--------------------------------SDS--------------SS----------D-------------------------------S?-D------X--XX--------------------------XXXX---------------------XXXX-----
------------------------------------------->----------------------------------------------------------XXXXXX-X-X--------------------XXXXXX--------------------XXXXX---X-
---------------<>-------------------------[>------------<>------------<>-----------------------------XXXXXXXX-XX--------------->---XXXXXXXX----------------<>-XXXXXX-XXX
---------EE-E-[[]-E---------]X-------EE-E-[]--E---------[]---E----E---[]----------------------E----XXXXXXXXXXXXX----------E----]--XXXXXXXXX----------------[]XXXX-X-XXXX
XXXXXXXXXXXXXXXXXXXXXXXXXXXXXXXXXXXXXXXXXXXXXXXXXXXXXXXXXXXXXXXXXXXXXXXXXXXXXXXXXXXXXXXX---XXX-------XXXXXXXXXXXXXXXXXXXXXXXXXXXXXXXXXXXXXXXXXXXXXXXXXXXXXXXXXXXXXXXXXXX