------------------------------------------------------------------------------------------------------------------------------------------------------------------------
------------------------------------------------------------------------------------------------------------------------------------------------------------------------
------------------------------------------------------------------------------------------------------------------------------------------------------------------------
------------------------------------------------------------------------------------------------------------------------------------------------------------------------
------------------------------------------------------------------------------------------------------------------------------------------------------------------------
----------------SS----SS------SSSSD---------------------SS---SSS--------------------------------------------------------------------------------------------------------
------------------------------------------------------------------------------------------------------------------------------------------------------------------------
------------------------------E-----------------------------------------------------------------------------------------------------------------------------------------
-------------------------------------------------------------------------------------------------------------------------------------------X----------------------------
----------------------XX------S--D---S--D--------DS-----------------D------XXXX-XX-X-------------------------------------------------XXXXXXX-----S--D--D--D--->---------
----------------------XX---X----------------<--------->------------------XXXXXX-XXXX---------------------------------------------XX-XXX--XXX-----------------[]---------
------------------X-XXXX--XX---------------[]>-------<>-----------------XXXXXXXXXXXX--------------------------------------------XXXXXXX--XXX-----------------[]----XX---
------------------XXXXXXXXXX[E---E----E-E--[[]-------[]----------------XXXXXXXXXXXXX---------------------------X--X-------------XXXXXXX--XXX-E---------E-----[]----XX---
----------------------XXXXXXXXXXXXXXXXXXXXXXXXXXXXXXXXXXXXXXXXXXXXXXXXXXXXXXXXXXXXXXXXXXXXX--XXXXXXXXXXXXXXXXXXXXXXXXXXXX------XXXXXXXXXXXXXXXXXXXXXXXXXXXXXXXXXXXXXXXXX