------------------------------------------------------------------------------------------------------------------------------------------------------------------------
------------------------------------------------------------------------------------------------------------------------------------------------------------------------
------------------------------------------------------------------------------------------------------------------------------------------------------------------------
------------------------------------------------------------------------------------------------------------------------------------------------------------------------
------------------------------------------------------------------------------------------------------------------------------------------------------------------------
SSS--SSS-------------------------------------------------SSSSSSS-D----------?----SSS---D-------------------------SSSSSSSSD---------------------?S-----------------------
------------------------------------------------------------------------------------------------------------------------------------------------------------------------
------------------------------------------------------------------------------------------------------------------------------------------------------------------------
------------------------------------------------------------------------------------------------------------------------------------------------------------------------
----D------D---------D----------SSS-S-------<>------X-----D-S---------S>----S-SSS--S----SSS-S-------<>-----XX--------D------D------XXX-----------D--DS?----------X--XX--
--------------------------------------------[]-----XXX-----------------]----------------------------[]-----XX------------------->--XX---XX--->------------------XX-XXX--
---------------<>--------<>-----------------[]-----XXX-----------------]----------------------------[]----XXX------------------<>-XXX--XXX--<]--------------<>XXXXXXXX--
---------------[]-E------[]--E-E-E-----E----[]--EX-XXX----------EE-E--[]-------------E---------E----[]---XXXX----E--------E----[]-EXX-XXXX--[]---E----E-E---[]XXXXXXXX--
XXXXXXX--XXXXXXXXXXXXXXXXXXXXXXXXXXXXXXXXXXXXXXXXXXXXXXXXXXXXXXXXXXXXXXXXXXXXXXXXXXXXXXXXXXXXXXXXXXXXXXXXXXXXXXXXXXXXXXXXXXXXXXXXXXXXXXXXXXXXXXXXXXXXXXXXXXXXXXXXXXXXXXX