------------------------------------------------------------------------------------------------------------------------------------------------------------------------
------------------------------------------------------------------------------------------------------------------------------------------------------------------------
------------------------------------------------------------------------------------------------------------------------------------------------------------------------
-------------------------------------------------------------------------------------------X----------------------------------------------------------------------------
----------------------------------------------------------------X---------------------------X------------------------------------------------------------------------EE-
--------------------------------------------SS----SSS---SS---SSSSD--------------S------SSSSSSSSS----------------SS---SSS-----------------------DS---------------?SSSXSSS
------------------------------------------------------------------------------------------------------------------------------------------------------------------------
----------------------------------------------------------------------------------------------------------------------------------------------------------------E-------
------------------------------------------------------------------------------------------------------------------------------------------------------------------------
--------D----------X--XXXX--------------------------------------------------------------------------->---X--X-----------------------------------SSS-------<>---?S--SS---
-----------------XX--XXXXX--------------------------------------------------------------------------<]---X--XXXX------------------------------------------[]------------
-----------------XXXXXXXXXX-------------------------------------------<>----------------------------[]--XX--XXXX--------------->--------------------------[]------------
--------E--------XXXXXXXXXXS---------------E-----------E--------------------------------------------[]--XX--XXXX---------E-----]-------------E-E-E------E-[]-------EE---
XXXXXXXXXXXXXXXXXXXXXXXXXXXX------------------------XXXX---XXX--------XXXXXXXXXXXXXXXXX---XXX--XXXXXXXXXXXXXXXXXXXXXXXXXXXXXXXXXXXXXXXXXXXXXXXXXXXXXXXXXXXXXXXXXXXXXXXXX