------------------------------------------------------------------------------------------------------------------------------------------------------------------------
------------------------------------------------------------------------------------------------------------------------------------------------------------------------
-----------------------------------------------------------------------------------------------------------------------XX-----------------------------------------------
-----------------------------------------------------------------------------------------------------------------------XXX----------------------------------------------
-----------------------------------------------------------------------------------------------------------------------XXX----------------------------------------------
---------------------------------------------------SS--------------------SSSSSSS-SSS------------------------------------XXXX---------SSS--------------------------------
------------------------------------------------------------------------------------------------------------------------------------------------------------------------
-----------------------------------------------------------------------E------------------------------------------------------------------------------------------------
------------------------------------------------------------------------------------------------------------------------------------------------------------------------
-------------------XXXX---XX-------------------S----------------------SS----S------------------D-------X-XX--X---DS--------------<>----XX------------------------XXXXXXX
-----------------XXX--X---XX--------------------------------------------------------------------------XXX-XXXXX------------------[]----X------------------------XXXXXX-X
-----------------XXX--X---XX--------------<>--------------------------------------------------------XXXXX-XXXXX------------------[]---XXX-------------------XXXXXXXXXXXX
-----------------XXXX-X--XXX--------------[]--------------------E------E-----------E----------------XXXXX-XXXXX-------E-E----E-E-[]--X-XX-------------------X]XXXXXXXXXX
--------------------X----XXXXXXXXXX--XXXXXXXXXXXXXXXXXXXXXXXXXXXXXXXXXXXXXXXXXXXXXXXXXXXXXXXXXXXXXXXXXXXXXXXXXXXXXX-XXXXX--XXXXXXXXXXXXXXXXXXXXXXXXXXXXXXXXXXXXXXXXXXXXX