------------------------------------------------------------------------------------------------------------------------------------------------------------------------
------------------------------------------------------------------------------------------------------------------------------------------------------------------------
------------------------------------------------------------------------------------------------------------------------------------------------------------------------
------------------------------------------------------------------------------------------------------------------------------------------------------------------------
------------------------------------------------------------------------------------------------------------------------------------------------------------------------
-SSSSSSSSD-------------SSS-S---SS?D-------------------------------------------------------------------------------------------------------------------------------------
------------------------------------------------------------------------------------------------------------------------------------------------------------------------
------------------------------E-----------------------------------------------------------------------------------------------------------------------------------------
------------------------------------------------------------------------------------------------------------------------------------------------------------------------
------------D------S-S-------?S--D---S?-D------X----X--------------D------------------------------SS------SS------------------D-----------------SSSD------D------S------
-----------------------------------------------XX--XXX------------------------------------------------------------------------------------------------------------------
--------------<>>---------------------------<XXXX--XXX------------------<--------X--------------------------------------------------------------------------------------
----------E---[[]-----------[----E----E-E---[XXXX-XXXX------------------]--------[]----------EE-E-----------------------------------------------------------------------
XXXXXXXXXXXXXXXXXXXXXXXXXXXXXXXXXXXXXXXXXXXXXXXXXXXXXXXXXXXXXXXXXXXXXXXXXXXXXXXXXXXXXXXXXXXXXXXXXXXXXXXXXXXXXXXXXXXX-XXXX--XXXXXXXXXX-XXXXXXXXXXXXXXXXXXXXXXXXXXXXXXXXXX