------------------------------------------------------------------------------------------------------------------------------------------------------------------------
------------------------------------------------------------------------------------------------------------------------------------------------------------------------
------------------------------------------------------------------------------------------------------------------------------------------------------------------------
-------XX---------------------------------------------------------------------------------------------------------------------------------------------------------------
-------XX---------------------------------------------------------------------------------------------------------------------------------------------------------------
---SSSSSSDS?--------------------------------------SSSSXS----SD----------------------SSSSSSSSS---------------------------------------------------------------------------
------------------------------------------------------------------------------------------------------------------------------------------------------------------------
--E----------------------------------------------E----------------------------------------------------------------------------------------------------------------------
------------------------------------------------------------------------------------------------------------------------------------------------------------------------
-DS--------------------------------------------S-S---------------S--D---------S-------D----------------XXXX--------------------------------------D--D------<>-----SS----
----------------<X-------X-----------------------------------------------[----------------------------XXX--XXX------------------------------->-------------[]-----------
----------------[]------XXX----------------------------------------------<>------------------------<>XXXX-XXXX------------------------------<]-------------[]-----------
------E-E-------[]--X---XXX---------------------------------------E-E----[]------------------------[XXXXX-XXXX--------------------XX--X-----[]-E-E------E--[]-E---------
XXXXXXXXX--XXXXXXXXXXXXXXXXXXXXX--------XXXXXXXXXXXXXXXXXXXXXXXXXXXXXXXXXXXXXXXXXXXXXXXXXX---XXX-XXXXXXXXXXXXXXXXXXXXXXXXXXXXXXXXXXXXXXXXXXXXXXXXXXXXXXXXXXXXXXXXXXXXXXX