------------------------------------------------------------------------------------------------------------------------------------------------------------------------
------------------------------------------------------------------------------------------------------------------------------------------------------------------------
------------------------------------------------------------------------------------------------------------------------------------------------------------------------
---------------------------------------------------------------------------------------------------------------------------------------------------XX-------------------
---------------------------------------------------------------------------------------------------------------------------------------------------XX-------------------
----------------SSS--------------SSSS----------------------------------------------------------------SSS------------S------------------------------XXXX-----SSSD----SSSS
------------------------------------------------------------------------------------------------------------------------------------------------------------------------
------------------------------------------------------------------------------------------------------------------------------------------------------------------------
------------------------------------------------------------------------------------------------------------------------------------------------------------------------
----------------------XX--X?----S--------------S-------------D--DS-------<>-----------------------SS---------------------------------XXX--XX--------------D----S?S------
---------------------XX---XX--------------->------------->---------------[]-----------------------------------------------------<X---XXX-XXX----------------------------
-----------------[]--XX---XX--------------[>---------X--<]---------------[]-----------------------------------------------------[XXX-XXX--XX----------------------------
-------------E---[]XXXX---XX----------E---[]--E-----XX--[]----------E----[]-EE---E-E--------------------------------------E-----[]XXXXXX-XXX----------------------------
XXXX--XX----XXXXXXXXXXX-XXXXXXXXXXXXXXXXXXXXXXXXXXXXXXXXXXXX--XXXX-XXXXXXXXXXXXXXXXXXXXXXXXXXXXXXXXXXXXXXXXXXXXXXXXXXXXXXXXXXXXXXXXXXXXXXXXXXXXXXXX--XXXXXXXXXXXXXXXXXXX