------------------------------------------------------------------------------------------------------------------------------------------------------------------------
------------------------------------------------------------------------------------------------------------------------------------------------------------------------
------------------------------------------------------------------------------------------------------------------------------------------------------------------------
------------------------------------------------------------------------------------------------------------------------------------------------------------------------
------------------------------------------------------------------------------------------------------------------------------------------------------------------------
S-----------------------SSSS---------------------S-------------------------------SSS-SSSSSSS------------------------S--------------------------SSSD---------------------
------------------------------------------------------------------------------------------------------------------------------------------------------------------------
----------------------------------------------------------------------------------------------------------------------------------------------E-------------------------
------------------------------------------------------------------------------------------------------------------------------------------------------------------------
----SSSD------<>---S?S----------SSSDS--D--DS--------X-------SSS-------<>---SSS-S---S----------------------XX-----DS--------------<>---X------?S-----D-DD-------XXX--XX--
--------------[]-----------------------------------XX-----------------[]--------------------------->---X---XX--------------------[]-------XX-------------------XX-XXXX--
--------------[]----------------------------<<-----XX-----------------[]---------------------------[>--X--XX---------------------[]-------XX---------------<>-XXX-XXXXX-
--------------[]-------------E-E-E-----E----[]-----XX------------EE-E-[]----------E----------EE----[]-EX--XXX---------E------E-E-[]-E-----XX------E-E------[XXXXXXXXXXX-
XXXXXXXXXXXXXXXXXXXXXXXXXXXXXXXXXXXXXXXXXXXXXXXXXXXXXXXXXXXXXXXXXXXXXXXXXXXXXXXXXXXXXXXXXXXXXXXXXXXXXXXXXXXXXXXXXXX---XXX---XXXXXXXXX----XXXXXXXXXXXXXXXXXXXXXXXXXXXXXXX