------------------------------------------------------------------------------------------------------------------------------------------------------------------------
------------------------------------------------------------------------------------------------------------------------------------------------------------------------
------------------------------------------------------------------------------------------------------------------------------------------------------------------------
------------------------------------------------------------------------------------------------------------------------------------------------------------------------
------------------------------------------------------------------------------------------------------------------------------------------------------------------------
---------------------------------------------------------------------------------------------------------------------------------SSS?S------SS---SSS--------------------
------------------------------------------------------------------------------------------------------------------------------------------------------------------------
------------------------------------------------------------------------------------------------------------------------------------------------------------------------
----------------------------------------------------E-------------------------------------------------------------------------------------------------------------------
---------------------------------DS-D-------<>-----XX--------D------D------XXX---X-X-----------D---------------------DSDS-----SS----S-----------SS-------------SDS------
----------------------------X>--------------[]-----XX------------------->--XX---XXX------------------[----------->----------------------------------------[>------------
-----------------------XX---<]--------------[]----XXXX--<>-------------[]--XX---XXXX-----------------[]-------XX<>----------------------------------------[]------------
-----------------------XX---[]-E-E-----E----[]--XXXXXX-S[]---E---EE----[]-EXX--XXXXX--------E--E-----[]-E----XXX[]-E-E-----E-----[]-----EEEE--------------[]------------
XXXXXXXXXXXXXXXXXXXXXXXXXXXXXXXXXXXXXXXXXXXXXXXXXXXXXXXXXXXXXXXXXXXXXXXXXXXXXXXXXXXXXXXXXXXXXXXXXXXXXXXXXXXXXXXXXXXXXXXXXXXXXXXXXXXXXXXXXXXXXXXXXXXXXXXXXXXXXXXXXXXXXXXX