------------------------------------------------------------------------------------------------------------------------------------------------------------------------
------------------------------------------------------------------------------------------------------------------------------------------------------------------------
------------------------------------------------------------------------------------------------------------------------------------------------------------------------
---------------------------------------------------------------XX-------------------------------------------------------------------------------------------------------
---------------------------------------------------------------XX-------------------------------------------------------------------------------------------------------
---SSDD---------------------------D----------------------------XXD---------D-------------------------------------------------------D--------------SS--------------------
------------------------------------------------------------------------------------------------------------------------------------------------------------------------
------------------------------------------------------------------------------------------------------------------------------------------------------------------------
------------------------------------------------------------------------------------------------------------------------------------------------------------------------
-----D--D------<>-------XX---?S-----D--D---------------------------D--DS----SS-----S-----D----------<>----S-------------------S--<>------------------------------D------
X>-------------[>--XX--XXX------------------->--------XX--------------------------------------------[]-------->------------------[]-------------------------------------
<]-------------[]--X---XXX------------------<>--------XX--------------------------------------------[]-------<>------------------[]-------------------------<>-------<>-
[]-E-E------E--[]------XXX----------E--E----[]--XXXXXXXX-----------------------------X----------E---[]-------[]X-----------------[]-------EE----------------[]-------[]-
XXXXXXXXXXXXXXXXXXXXXXXXXXX-XXXXXXXXXXXXXXXXXXXXXXXXXXXXXXXXXXXXXXXXXXXXXXXXXXXXXXXXXXXXXXXXXXXXXXXXXXXXXXXXXXXXXXXXXX----XXXXXXXXXXXXXXXXXXXXXXXXXXXXXXXXXXXXXXXXXXXXXX