------------------------------------------------------------------------------------------------------------------------------------------------------------------------
------------------------------------------------------------------------------------------------------------------------------------------------------------------------
------------------------------------------------------------------------------------------------------------------------------------------------------------------------
------------------------------------------------------------------------------------------------------------------------------------------------------------------------
------------------------------------------------------------------------------------------------------------------------------------------------------------------------
SSS--SSSSS-----------------------------------------------------------------------------------------------------------------------------------S-SSSSSSD--------------S---
------------------------------------------------------------------------------------------------------------------------------------------------------------------------
------------------------------------------------------------------------------------------------------------------------------------------------------------------------
------------------------------------------------------------------------------------------------------------------------------------------------------------------------
-------------------X---------------------------X------------------------------X-----------------------------------------------S--------------------------------S--------
--------------->---X---XX---------------------XXX---X------------------------------X----------------------------------------------------------------------->------------
--------------<>--X----XX------------------<>XXX---XXX----------------------------XX-------------------------<>-------------------------------------------<>------------
--------------[]]-EX--XXX------------------XXXXX--XXXX---------------------X-------X----------E------X----------------------------------E-------------E---[]--E---------
XXXXXXX--XXXXXXXXXXXXXXXXXXXXXXXXXXXXXXXXXXXXXXXXXXXXXXXXXXX---XX---XX-XXXXXXX--XXXXXXXXXXXXXXXXXXXXXXXXXXXXXXXXXXXXXXXX-XXXXXXXXXXXXXXXXXXXXXXXXXXXXXXXXXXXXXXXXXXXXXXX