------------------------------------------------------------------------------------------------------------------------------------------------------------------------
------------------------------------------------------------------------------------------------------------------------------------------------------------------------
------------------------------------------------------------------------------------------------------------------------X-----------------------------------------------
-----------------------------------------------------------------------------------------------------------------------XXX----------------------------------------------
-----------------------------------------------------------------------------------------------------------------------XXX-----------------------------------------E----
-SSSSSDSSSSD-------------------------------------------------------------------------------------------------------------XXX-------------------------------------SSSSSXS
------------------------------------------------------------------------------------------------------------------------------------------------------------------------
-----------------------------------------------------------------------------------------------------------------------------------------------------------------E------
------------------------------------------------------------------------------------------------------------------------------------------------------------------------
----------------<>--------------S----------------SS----------------------<----XXX--------------D--D------S-----------------------<>---XX--XX--------------S-----?-------
----------------[]-------------------------------------------------------[>---XXX------------------------------------------------[]---X---XX----------------------------
----------------[]-------<>----------------------------------------------[]---XXX-X----------------------------------------------[]---X---XX----------------------------
----------E-E---[]-------[]--------------------------------------E-E-----[]-XXXXXX-X-----------------------------------------E-E-[]-EX----XX---------------E-----------E
XXXXXXXXXXXXXXXXXXXXXXXXXXXXXXXXXXXXXXXXXXXXXXXXXXXXXXXXXXXXXXXXXXXXXXXXXXXXXXXXXXXXXXXXXXXXXXXXXXXXXXXXXXXXXXXXXXX---XXX---<XXXXXX-XX---XXXXXXX--XXX--XXXXXXXXXXXXXXXXX