------------------------------------------------------------------------------------------------------------------------------------------------------------------------
------------------------------------------------------------------------------------------------------------------------------------------------------------------------
-------XX---------------------------------------------------------------------------------------------------------------------------------------------------------------
-------XXX--------------------------------------------------------------------------------------------------------------------------------------------------------------
-------XXX--------------------------------------------------------------------------------------------------------------------------------------------------------------
------XXXXXX-----------------------------------------------SSSDSSDS------------------SSSSSSSSD--------------------------------------------------------------------------
------------------------------------------------------------------------------------------------------------------------------------------------------------------------
----------------------------------------------------------E-------------------------------------------------------------------------------------------------------------
------------------------------------------------------------------------------------------------------------------------------------------------------------------------
--------------------------------SS--S--D--DS----SS-------DS-----D-------<>----------------------D------XXXX-XXXX----SSSDS-----<<>---S-SXX--------S--D--D--DS------S-----
------------------------------------------------------------------------[]---------------------------XXXXXX--XXX--------------[[]------XX-------------------------------
-----------------<------------------------------------------------------[]--------------------------XXXXXXXXXXXX<--------------[]------XX-------------------------------
---------------E-[]----------X-E------------------------------E-E-------[]-------EEE---------------XXXXXXXXXXXXX[X-E-E---------[]------XX---[E-E-E----------------------
XXX---XX----XXXXXXXXXXXXXXXXXXXXXXXXXXXXXXXXXXXXXXXXXXXXXXXXXXXXX--XXXXXXXXXXXXXXXXX---------------XXXXXXXXXXXXXXXXXXXXXXXXXXXXXXXXXXXXXXXXXXXXXXXXXXXXXXXXXXXXXXXXXXXXX