------------------------------------------------------------------------------------------------------------------------------------------------------------------------
------------------------------------------------------------------------------------------------------------------------------------------------------------------------
------------------------------------------------------------------------------------------------------------------------------------------------------------------------
------------------------------------------------------------------------------------------------------------------------------------------------------------------------
------------------------------------------------------------------------------------------------------------------------------------------------------------------------
-SSSSSSSSD-------------------S--SSS---------------------SSSSSSSSS-------------------S----------------------DS--------------------------------SSSSSSSSD-------------SSSSS
------------------------------------------------------------------------------------------------------------------------------------------------------------------------
------------------------------------------------------------------------------------------------------------------------------------------------------------------------
------------------------------------------------------------------------------------------------------------------------------------------------------------------------
--S---------D------------------------S?-D-------XXX--XXX------------------------------------------D----------------------------------S--------S----------------SD-------
-----------------------------------------------XXXX--XXX--------------->----------------------------------------------------------------------------------->------------
--------------<<>-X------<>----------------<>-XXXXX--XXX--------------<>----------------------------------------------------------------------------------<>------------
----------E---[[]XE------[-----------EE-E--[]XXXXXX-XXXX----------E---[]--E---------------------------------------------------------------E-----------E---[]------------
XXXXXXXXXXXXXXXXXXXXXXXXXXXXXXXXXXXXXXXXXXXXXXXXXXXXXXXXXXXXXXXXXXXXXXXXXXXXXXXXXXXXXXXXXX----XXXXXXXXXXXXXXXXXXXXXXXXXXXXXXXXXXXXXXXXXXXXXXXXXXXXXXXXXXXXXXXXXXXXXXXXXX