------------------------------------------------------------------------------------------------------------------------------------------------------------------------
------------------------------------------------------------------------------------------------------------------------------------------------------------------------
------------------------------------------------------------------------------------------------------------------------------------------------------------------------
------------------------------------------------------------------------------------------------------------------------------------------------------------------------
------------------------------------------------------------------------------------------------------------------------------------------------------------------------
S------------------------------SS?D------------------------?SSS--------------------------------------------------SSSSSSSSD------------------SSS--SSSSD------------------
------------------------------------------------------------------------------------------------------------------------------------------------------------------------
------------------------------------------------------------------------------------------------------------------------------------------------------------------------
------------------------------------------------------------------------------------------------------------------------------------------------------------------------
---------------------S-----------D--D-------<>----SXX-------SSS-------->-------XX------------------------------------------------------------------------------X-XX---X-
----------------------------->--------------[]------------------------[>-------XX----------------------------------------------------------------------------XXXXXX--XX-
----------------------------<]--------------[]------X-----------------[]------XXX------------------<---------------------------->XX------<>-----------------XXXXXX---XXX
---------E------------------[]-E-E------E---[]---E--XE-E-E--------E---[]--E---XXX------------E----------------------------------XXXX-----[]----------------XXXXXX-X-XXXX
XXXXXXXXXXXXXXXXXXXXXXXXXXXXXXXXXXXXXXXXXXXXXXXXXXXXXXXXXXXXXXXXXXXXXXXXXXXXXXXXXXXXXXXXXXXXXXXXXXXXXXXXXXXXXXXXXXXXXXXXXXXXXXXXXXXXXXXXXXXXXXXXXX--------XXXXXXXXXXXXXX