------------------------------------------------------------------------------------------------------------------------------------------------------------------------
------------------------------------------------------------------------------------------------------------------------------------------------------------------------
------------------------------------X-----------------------------------------------------------------------------------------------------------------------------------
-----------------------------------XXX----------------------------------------------------------------------------------------------------------------------------------
-----------------------------------XXX----------------------------------------------------------------------------------------------------------------------------------
SS---------------------------------XXXXX----SS----SSSS-------------------------------SSSSSDSSSS--------------------?S--------------------------SSSSSSDS-----------------
------------------------------------------------------------------------------------------------------------------------------------------------------------------------
------------------------------------------------------------------------------------------------------------------------------------------------------------------------
------------------------------------------------------------------------------------------------------------------------------------------------------------------------
-----------D-------S-S-------------------------------------------------------------------S------------------X---<----D--D-D-----X--XXX-XXX----S------------------XX-XX-X
--------------------------------------------------------------------------------------------------------X---XX--E>-------------->--XX--XXX------------------<X--XXX-XXXX
----------------------------------------------------------------------------------------------------<---X--XXX--<]--------------<>-XXXXXXXX-----------------[XXXXXXXXXXX
-------------------------------------------E-------------------------------------------------------[]---XXXXXX--[]-E-E---------X[]-XXXXXXXX-----------------[]XXXXXXXXXX
XXXXXXX--XXXXXXXXXXXXXXXXXXX--------------------------XX--XXX---------------------XXXXXXXXXXXXXXXXXXXXXXXXXXXXXXXXXXXXXXXXXXXXXXXXXXXXXXXXXXXXXXXXXXXXXXXXXXXXXXXXXXXXXX