------------------------------------------------------------------------------------------------------------------------------------------------------------------------
------------------------------------------------------------------------------------------------------------------------------------------------------------------------
------------------------------------------------------------------------------------------------------------------------------------------------------------------------
------------------------------------------------------------------------------------------------------------------------------------------------------------------------
------------------------------------------------------------------------------------------------------------------------------------------------------------------------
S-----------------------SS-----SSSS-------------------------------------SSS---SSS---------------------------------------------------------------------------------------
------------------------------------------------------------------------------------------------------------------------------------------------------------------------
------------------------------------------------------------------------------------------------------------------------------------------------------------------------
------------------------------------------------------------------------------------------------------------------------------------------------------------------------
-----------------------------DS------S------------------------------------------------S--S--D--D--DS----S---------------------------------------------------------X-----
------------------------------------------------------------------------------------------------------------------------------------------------------------------------
------------------------------------------<>---------------------------------------X-----------------------------------------------------------------------------XX---XX
------------------------------------E------]--------------X-----------------------XX[E-E-E--E----------------------------E--E---------------------------------XXXXX---XX
XXXXXXX--XXXXXXXXXXXXXXXXXXXXXXXXXXXXXXXXXXXXXXXXXXXXXXXXXXXX--XXXXXXXXXXXXXXXX-XXXXXXXXXXXXXXXXXXXXXXXXXXXXXXXXXXXXXXXXXXXXXXXXXXXXXXXXXXXXXXXXXXXXXXXXXXXXXXXXXXXXXXXX