------------------------------------------------------------------------------------------------------------------------------------------------------------------------
------------------------------------------------------------------------------------------------------------------------------------------------------------------------
------------------------------------------------------------------------------------------------------------------------------------------------------------------------
------------------------------------------------------------------------------------------------------------------------------------------------------------------------
------------------------------------------------------------------------------------------------------------------------------------------------------------------------
-------------------------------------------------S------------------------------------------------------------------------------------------S---------------------------
------------------------------------------------------------------------------------------------------------------------------------------------------------------------
------------------------------------------------------------------------------------------------------------------------------------------------------------------------
------------------------------------------------------------------------------------------------------------------------------------------------------------------------
---------------------------------S--S-----SS<D-----XX-------------------->-----XXX---D--------------------XX------------------------------------------------------XX--XX
---------------------X---X------------------[]-----XX-------------------[]---X--XX-X---------------------XXX---X----------------------------------------------XX-XX---XX
----------------<>--XX---XX-----------------[]----XXX-------------------[]--XX--XXXX-----------------X---XXX--XX-----------------XX---XXX--------------------XX---X---XX
----------------[]--XX---XXX-X-E-E-----E----[]---X-XXE-E-----------E----[]--XX-XXXXX-----------------[XXXXXX--XX-X---------------XXXXXXXXX-------------------XXX--X--XXX
XXXXXXXXXXXXXXXXXXXXXXXXXXXXXXXXXXXXXXXXXXXXXXXXXXXXXXXXXXXXXXXXXXXXXXXXXXXXXXXXXXXXXXXX--XXX--XXXXXXXXXXXXXXXXXXXXXXXXXXXXXXXXXXXXXXXXXXXXX--------------------------X-