------------------------------------------------------------------------------------------------------------------------------------------------------------------------
------------------------------------------------------------------------------------------------------------------------------------------------------------------------
-------XX---------------------------------------------------------------------------------------------------------------------------------------------------------------
-------XXX--------------------------------------------------------------------------------------------------------------------------------------------------------------
------XXXX--------------------------------------------------------------------------------------------------------------------------------------------------------------
SS----XXXXXX----SSS---SSS------------------------SSS----------------------------------------------------------------------------------------SSS--SSSSD------------------
------------------------------------------------------------------------------------------------------------------------------------------------------------------------
------------------------------------------------------------------------------------------------------------------------------------------------------------------------
------------------------------------------------------------------------------------------------------------------------------------------------------------------------
------------------------------------------S-----------------SSS-D--D--DS----------------------------------X----------------D--------------------------------------------
---------------------------------------------------X------------------------------------------------------XX------------------------------------------------------------
--------------------------------------------------XX--------------------------------------------------X---XXX-------------------<>-------<>------------------<----------
-------------------X--X--------------------]------XXX----E-E-E----------------------------------------XX--XXX----X--------------[]-------[]----------E------------------
XXXXXXX---XXXXXXXXXXXXXXXXXXXXXXXXXXXXXXXXXXXXXXXXXXXXXXXXXXXXXXXXXXXXXXXXXXXXXXXXXXXXXXXXXXXXXXXXXXXXXXXXXXXXXXXXXXXXXXXXXXXXXXXXXXXXXXXXXXXXXXXXX--XXXXXXXXXXXXXXXXXXX