------------------------------------------------------------------------------------------------------------------------------------------------------------------------
------------------------------------------------------------------------------------------------------------------------------------------------------------------------
--------------------------------------------------------------------------------------------X---------------------------------------------------------------------------
-------------------------------------------------------------------------------------------XX---------------------------------------------------------------------------
---------------------------E---------------------------------------------------------------XXX--------------------------------------------------------------------------
------------------SS?SSSSSSS--S-SSSS-------------------------------------------------S-SSSSXXXXX----------------SSS--SSSSS----------------------------------------------
------------------------------------------------------------------------------------------------------------------------------------------------------------------------
---------------E--------------------------------------------------------------------------------------------------------------------------------------------------------
------------------------------------------------------------------------------------------------------------------------------------------------------------------------
--------------SS----SS----?S-----D------D------XXXX--X----------D--------<>---S------D----------------XX-XX---------SS-------------S----------D--------D--D-------------
-----------------------------------------------XX---XXX------------------[>-------XX-----------------XXX--XX-X----------------->----------------------------------------
-------------------------------------------<>-XXX--XXXX------------------[]-------XX-----------------XXXX-XXXXX---------------<>---------<>------------------<----------
------------E--E--------E-E-----------E----[]XXXX-XXXXX------------E----[[]-E-----XX---------------XXXXXXXXXXXX---------------[]--E------[]---------E-------------------
XXXXXXXXXXXXXXXXXXXXXXXXXXXXXXXXXXXXXXXXXXXXXXXXXXXXXXXXXXXXXXXXX--XXXXXXXXXXXXXXXXX----------------XXXXXXXXXXXXXXXXXXXXXXXXXXXXXXXXXXXXXXXXXXXXXXXXXXXXXXXXXXXXXXXXXXXX