------------------------------------------------------------------------------------------------------------------------------------------------------------------------
------------------------------------------------------------------------------------------------------------------------------------------------------------------------
------------------------------------------------------------------------------------------------------------------------------------------------------------------------
------------------------------------------------------------------------------------------------------------------------------------------------------------------------
------------------------------------------------------------------------------------------------------------------------------------------------------------------------
----------------------------------------------------------------------------------------------------------------SS-SSSSSSD-------------------SSSSSSS--------------------
------------------------------------------------------------------------------------------------------------------------------------------------------------------------
------------------------------------------------------------------------------------------------------------------------------------------------------------------------
-----------------------------------------------------------------------------------X------------------------------------------------------------------------------------
----SDSXS------<>----D----------------------------X---XX--------------------XXX---XX--------------<>------S----------------------<>-------------SS---------<---X--------
---------------[]-------->>------------------XX---X---XX-----------------XX-XXX--XXX--------------[]-----------------------------[]------------------------>>------XX---
<--------------[]-------<<>------------------XX---X---XX----------------XXXXXXX--XXX--------------[]-----------------------------[]------------------------[]------XX---
[E-E-E-----EE--[]-------[[]------------------XXX--X---XX---------------XXXXXXXX--XXX--------------[]-----------E--------E--E-E---[]-----------------E------[]-E---XXX---
XXXXXXXXXXXXXXXXXXXXXXXXXXXX-------------------------XXXXXXXXX----------XXXXXXX-XXXXXXXXXXXXXXXXXXXXXXXXXXXXXXXXXXXXXXXXXXXXXXXXXXXXXXXXXXXXXXXXXXXXXXXXXXXXXXXXXXXXXXXX