------------------------------------------------------------------------------------------------------------------------------------------------------------------------
------------------------------------------------------------------------------------------------------------------------------------------------------------------------
------------------------------------------------------------------------------------------------------------------------------------------------------------------------
------------------------------------------------------------------------------------------------------------------------------------------------------------------------
------------------------------------------------------------------------------------------------------------------------------------------------------------------------
---SS--------------------------SSSD------------S?SD--SSS---SSSD----D----------------SSS--SSSS---------------------------------------------------S-----------------------
------------------------------------------------------------------------------------------------------------------------------------------------------------------------
--E---------------------------------------------------------------------------------------------------------------------------------------------------------------------
------------------------------------------------------------------------------------------------------------------------------------------------------------------------
-DS------S------<>>-----X-----S-----------SSS---S------S----------------<>------X-------SS-------------SDS----------SSSDS---------------X----DS--------------XX---------
----------------[]]----X------------------------------------------------[]------X-----------------------------------------------<-------XX-------------------XX---------
----------------[[]-----X-----------------------------------------------[]------XX----------------<<>---------------------------<>--X---XX------------------[XX-------X-
------E-----E---X]--EE-XXE-E---------EE-E-----------EEEE----------EEE---[]--EE--EE-----------------[]-E----------E--------------[]--XX--XX--------E---------XXX------X-X
XXX---XXX--XXXXXXXXXXXXXXXXXXXXXXXXXXXXXXXXXXXXXXXXXXXXXXXXXXXXXXXXXXXXXXXXXXXXXXXXXXXXXXXXXXXXXXXXXXXXXXXXXXXXXXXXXXXXXXXXXXXXXXXXXXXXXXXXXXXX--XXXX---XXXXXXXXXXXXXXXX