------------------------------------------------------------------------------------------------------------------------------------------------------------------------
------------------------------------------------------------------------------------------------------------------------------------------------------------------------
------------------------------------------------------------------------------------------------------------------------------------------------------------------------
------------------------------------------------------------------------------------------------------------------------------------------------------------------------
------------------------------------------------------------------------------------------------------------------------------------------------------------------------
---------------------SS--SSS---SS?D------------------------------------------------------------------------------S---SSS------------------------------------------------
------------------------------------------------------------------------------------------------------------------------------------------------------------------------
------------------------------E-----------------------------------------------------------------------------------------------------------------------------------------
------------------------------------------------------------------------------------------------------------------------------------------------------------------------
-DS-----------S--------------DS------S?-D-------------------S--------------X-X-------DS--------------<>---S--------------------------D-------------------------S-S------
---------------------------------------------------------------------------XX-X--X-------------------[]-------------------------<>-------->-----------------------------
-----------------[]------------------------<>XX-----------------------<<>-XXXXXXXXX------------------[]-------------------------<]-------[>X---------------<>-----------
--------E--E-E-E-[]-------------------E-E--[XXX------------------------[-XXXXXXXXXX---------E--E-E---[]-EE-----E---------E------[]-------[]X---------------[]-E---------
XXXXXXXX---XXXXXXXXXXXXXXXXXXXXXXXXXXXXXXXXXXXXXXXXXXXXXXXXXXXXXXXXXXXXXXXXXXXXXXXXXXXXXXXXXX--XXXXXXXXXXXXXXXXXXXXXXXXXXXXXXXXXXXXXXXXXXXXXXXXXXXXXXXXXXXXXXXXXXXXXXXXX