------------------------------------------------------------------------------------------------------------------------------------------------------------------------
------------------------------------------------------------------------------------------------------------------------------------------------------------------------
------------------------------------------------------------------------------------------------------------------------X-----------------------------------------------
------------------------------------------------------------------------------------------------------------------------XX----------------------------------------------
-----------------------------------------------------------------------------------------------------------------------XX-----------------------------------------------
-----------------------------SSSSSSSSD----------------------------------------SSSS-S-----SS------------------------------XX-----SSS--SSSSSXS----------------------------
------------------------------------------------------------------------------------------------------------------------------------------------------------------------
-------------------------------------------------------------------------------------------------------------------------------------E----------------------------------
------------------------------------------------------------------------------------------------------------------------------------------------------------------------
---------S?-D------XXXXX--XX----------------<>----S-------S--D--DSD--------------------------------------D-------DS-----------S----------------------S------------------
------------------XXXXX--XXX----------------[]---------------------------------------------------------------->---------------------------------------------------------
----------------XXXXXXXX-XXX----------------[]------------------------<>---------------------------<>--------[]-------------------------------------------<-------------
----------E----XXXXXX-XXXXXX----------------[]----------[E-E-E----E---[]---------------------------[]-EX-----[]X------E--------E---------------------------E-----------E
XXXX----X-------XXXXXXXXXXXXXXXXXXXXXXXXXXXXXXXXXXXXXXXXXXXXXXXXXXXXXXXXXXXXXXXXXXXXXXXXXXXXXXXXXXXXXXXXXXXXXXXXXXXX--XX----XXXXXXXXXXXXXXXXXXX---XXX---XXXXXXXXXXXXXXXX