------------------------------------------------------------------------------------------------------------------------------------------------------------------------
------------------------------------------------------------------------------------------------------------------------------------------------------------------------
--------------------------------------------------------------------------------------------X---------------------------------------------------------------------------
-------------------------------------------------------------------------------------------XX----------------------------X----------------------------------------------
-------------------------------------------------------------------------------------------XX---------------------------------------------------------------------------
------------------------------SSSSD-----------------------------------------?SDS-SSS------XXXXX--------------------------XX-----S---------------------------------------
------------------------------------------------------------------------------------------------------------------------------------------------------------------------
------------------------------------------------------------------------------------------------------------------------------------------------------------------------
---------------------------X--------------------------------------------------------------------------------------------------------------------------------------------
---------------------XXX-XXX--S-------------<>--------------SSSDS-----<>----S--SS----------------------------------------------------------------S--------DS----S-------
------------------XXXXX---XX----------------[]------------------------[]------------------------------------------------------------------------------------------------
------------------XXXXX---XX----------------[]-------X>---------------[]------------------------------------------------------------------------------------------------
-----------------XXXXXX--XXX---------EEEE---[]-------[]---------------[]-------EE----------------------------------------------E-------------X--------------------------
XXXX-------------XXXXXX-XXXXXXXXXXXXXXXXXXXXXXXXXXXXXXXXXXXXXXXXXXXXXXXXXXXXXXXXXXXXXXXXXX----XXXXXXXXXXXXXXXXXXXXX---XX----XXXXXXXXXXXXXXXXXXXXXXXXXXXXXXXXXXXXXXXXXXXX