------------------------------------------------------------------------------------------------------------------------------------------------------------------------
------------------------------------------------------------------------------------------------------------------------------------------------------------------------
------------------------------------------------------------------------------------------------------------------------------------------------------------------------
------------------------------------------------------------------------------------------------------------------------------------------------------------------------
------------------------------------------------------------------------------------------------------------------------------------------------------------------------
----------------------------S-------------------------------S----------------------------------------------------------------------S?SD---------------------------------
------------------------------------------------------------------------------------------------------------------------------------------------------------------------
------------------------------------------------------------------------------------------------------------------------------------------------------------------------
------------------------------------------------------------------------------------------------------------------------------------------------------------------------
-----DS-------->---?S---------------------------XXX---XX--S------S---------X-XXXXX----------------S-------S-------------D-----S--<>----?S----------------------X--------
->------------[>-----------------------------XX-XX----X--------------------XXXXXXX-----------------------------------------------[]------------------------>---X---XX---
<>------------[[]---------------------------XXXXXX---[EX----------------XXXXXXXXXXX------------------<>--------------------------[]-----------------------<>------XXXX--
[]-E-E--------[[]-E------------------------XXXXXX----[XX----------E-----XXXXXXXXXXXS---------E-EE----[---------------------E-E---[]--E-EEE-E----------E---[]--EX--XXXX--
XXXXXXXXXXXXXXXXXXXXXXXXXXXXXXXXX----------XXXXXXXX-XXXXXXXXXXXXXXXXXXXXXXXXXXXXXXXXXXXXXXXXXXXXXXXXXXXXXXXXXXXXXXXXXXXXXXXXXXXXXXXXXXXXXXXXXXXXXXXXXXXXXXXXXXXXXXXXXXXX