------------------------------------------------------------------------------------------------------------------------------------------------------------------------
------------------------------------------------------------------------------------------------------------------------------------------------------------------------
------------------------------------------------------------------------------------------------------------------------------------------------------------------------
------------------------------------------------------------------------------------------------------------------------------------------------------------------------
------------------------------------------------------------------------------------------------------------------------------------------------------------------------
SS-----------------------------?S----------------------------------------------------------------------------------D----------------------S-----------------------------
------------------------------------------------------------------------------------------------------------------------------------------------------------------------
------------------------------------------------------------------------------------------------------------------------------------------------------------------------
------------------------------------------------------------------------------------------------------------------------------------------------------------------------
-------------------XXXX---XX-----DS-D-------<>------XX--------------D-------XX----XX--------------------------------SSS-------<>---SSS-----------S--S------------X--XX--
------------------XX--X---XX->--------------[]-----XXX-------------------X-XXX---XX-------------------------------------------[]----------------------------<---XX--XX--
---------------<XXXX--X--XXX<]--------------[]-----XXX------------------XXXXXX---XXX------------------------------------------[]----------------------------<>-XXX-XXXXX
---------------XXXXX--X--XXX[]-E-E-----EE---[]--XX-XXX------------E-----XXXXX----XXX-----------------------------E-------E--E-[]-------------X-E-E----------[]-XXXXXXXXX
XXXX-----------XXXXXXXXXXXXXXXXXXXXXXXXXXXXXXXXXXXXXXXXXXXXXX-XXXXXXXXXXXXXXXXXXXXXXXXXXXX----X----XXXXXX----XXXXXXXXXXXXXXXXXXXXXXXXXXXXXXXXXXXXXXXXXXXXXXXXXXXXXXXXXXX