------------------------------------------------------------------------------------------------------------------------------------------------------------------------
------------------------------------------------------------------------------------------------------------------------------------------------------------------------
--------------------------------------------------------------------------------------------X---------------------------------------------------------------------------
--------------------------------------------------------------------------------------------XX--------------------------------------------------------------------------
-------------------------------------------------------------------------------------------X-X--------------------------------------------------------------------------
----------------------------------------------------------------------------------S-----S----XX---------?SSSSSSSSSS--SSSS------------------------------------------SSS-S
------------------------------------------------------------------------------------------------------------------------------------------------------------------------
--------------------------------------------------------------------------------------E---------------------------------------------------------------------------------
------------------------------------------------------------------------------------------------------------------------------------------------------------------------
-------------------S-------------------D---------S--------------------<>---SSS-----S-DS------S----S-----S----------------------------S---------------S------------------
----------------------------------------------------------------------[]------------------------------------------------------------------------------------------------
--------------<>------------------------------------------------------[]------------------------------------------------------<>--X------<>---------------<>------------
--------------[]-------------------------------------------------EE-E-[]----------E-------E-E----E-E--------E-------------E---[]---X------]-----------E---[]------------
XXXXXXXXXXXXXXXXXXXXXXXXXXXXXXXXXXXXXXXXXXXXXXXXXXXXXXXXXXXXXXXXXXXXXXXXXXXXXXXXXXXXXXX--XXXX---XXXXXXXXXXXXXXXXX-XXX----XX---XXXXXXXXXXXXXXXXXX---XXX---XXXXXXXXXXXXXXX