------------------------------------------------------------------------------------------------------------------------------------------------------------------------
------------------------------------------------------------------------------------------------------------------------------------------------------------------------
------------------------------------------------------------------------------------------------------------------------------------------------------------------------
------------------------------------------------------------------------------------------------------------------------------------------------------------------------
------------------------------------------------------------------------------------------------------------------------------------------------------------------------
---SSSD--------------------------------------------------S-SSSSS--------------------------------------------------------------------------------------------------------
------------------------------------------------------------------------------------------------------------------------------------------------------------------------
------------------------------------------------------------------------------------------------------------------------------------------------------------------------
------------------------------------------------------------------------------------------------------------------------------------------------------------------------
-?S------SD----------X--XX----------------D---------------S--------------------------------------------------------------S---------------------------S---------X--XX----
----------------<---X---XX---------------------------------------------[--------------------------------------------------------------------------------------XXXXXX---X
----------------<>-XXX-XXXX--------------------------------------------[]-------------------------------------------------------------------------------------XXXXXXX-X-
----------------[]-XXXXXXXX-------------------------------------E------[]-E----------------------------------------------------E-----------E-----------------XXXXXXXXXXX
XXXXXXXXXXXXXXXXXXXXXXXXXXXXXXXXXXXXXXXXXXXXXXXXXXXXXXXXXXXXXXXXXXXXXXXXXXXXXXXXXXXXX-----------XXXXXXXXXXXXXXXXXX-----XX----X-XXX-----XXXXXXXXXXXXXXXXXXX--XXXXXXXXXXXX