------------------------------------------------------------------------------------------------------------------------------------------------------------------------
------------------------------------------------------------------------------------------------------------------------------------------------------------------------
------------------------------------------------------------------------------------------------------------------------------------------------------------------------
------------------------------------------------------------------------------------------------------------------------------------------------------------------------
------------------------------------------------------------------------------------------------------------------------------------------------------------------------
-------------------------------SSSD--DS------------SS-------------------------SSSSSSSSS-SSSSSD--------------S----------S-----------------------?S-----------------------
------------------------------------------------------------------------------------------------------------------------------------------------------------------------
------------------------------E----------------------------------------------E------------------------------------------------------------------------------------------
------------------------------------------------------------------------------------------------------------------------------------------------------------------------
-----D-------------D---------?S------S-------<---------------S-DS--D--D----S?S-------------------------S-S-------------------------S-S-----------D--D------------X--XX--
--------------------------------------------------------------------------------------------------------------------------------------------->--------------<---XX--XXX-
--------------<>--X--------------------------[----------------------------------------------------<>>--------<>---------------<]------------<]--------------<>-XXX-XXXX-
-E--------E---[]--E---------------E------E-E-[]-----------------------------------------------E---[]]-E------[]---------------[]----------E-[]-E-E------E---[]-XXXXXXXX-
XXXXXXXXXXXXXXXXXXXXXXXXXXXXXXX---XXX---XXXXXXXXXXXXXXXXXXXXXXXXXXXXXXXXXXXXXXXXXXXXXXXXXXXXXXXXXXXXXXXXXXXXXXXXXXXXXXXXXXXXXXXXXXXXXXXXXXXXXXXXXXXXXXXXXXXXXXXXXXXXXXXX