------------------------------------------------------------------------------------------------------------------------------------------------------------------------
------------------------------------------------------------------------------------------------------------------------------------------------------------------------
------------------------------------------------------------------------------------------------------------------------------------------------------------------------
------------------------------------------------------------------------------------------------------------------------------------------------------------------------
------------------------------------------------------------------------------------------------------------------------------------------------------------------------
---------------------SSSSSSS-------------------------------SSSDS---------------------SSSSSSSS---------------------------------------------------------------------------
------------------------------------------------------------------------------------------------------------------------------------------------------------------------
------------------------------------------------------------------------------------------------------------------------------------------------------------------------
------------------------------------------------------------------------------------------------------------------------------------------------------------------------
----S---------<>----S-----------------------------S-------S--D--D-------<>----------------------D------XXXX--X---DS------SD------XX---XXX-------------------------S-----
--------------[]--------------------------------------------------------[]-------XX-------------------XXXXX-XXX------------------XX--XX--X-X----------------------------
--------------[]-----------------------------XX-------------------------[]-------X>----------------<>XXXXXXXXXXX-----------------X]--XX---XX----------------------------
---------E----[]--------E--------------------XX----------E-E-E--E--E----[]-------[]-----------E----[]XXXX-XXXXX-------------E----[XXXXX--XXX------------E--------------E
XXXXXXXXXXXXXXXXXXXXXXXXXXXXXXXXXXXXXXXXXXXXXXXXXXXXXXXXXXXXXXXXXXXXXXXXXXXXXXXXXXXXXXXXXXXXXXXXXXXXXXXXXXXXXXXXXXX---XXX---XXXXXXXXXXXXXXXXXXXXXXXXXXXXXXXXXXXXXXXXXXXX