------------------------------------------------------------------------------------------------------------------------------------------------------------------------
------------------------------------------------------------------------------------------------------------------------------------------------------------------------
------------------------------------------------------------------------------------------------------------------------------------------------------------------------
------------------------------------------------------------------------------------------------------------------------------------------------------------------------
------------------------------------------------------------------------------------------------------------------------------------------------------------------------
------------------SS?SD---SS----SSD--------------------------------------------------S--S-------------------------------------------------------------------------------
------------------------------------------------------------------------------------------------------------------------------------------------------------------------
------------------------------------------------------------------------------------------------------------------------------------------------------------------------
------------------------------------------------------------------------------------------------------------------------------------------------------------------------
----SSSDS--D--DS---?S------------S-D---D---------S-----------DS--------<>--------------------S---------X-XX---XX---------------------SS-------------------S------S------
-----------------------------------------------------------------------[]------XX--------------------XXX-XX---XX--------------------------------------------------------
-----------------------------------------------------------------------[]------XXX-------------------XXXXXX---XX--------------[]----------------------------------------
-E-E--------------------E-------------------]-----------[]-E-E---------[]-E----XX------------------XXXXXX-X--XXX---------EE-E-[]--------------------------------------E-
XXXXXXXXXXXXXXXXXXXXXXXXXXXXXXXXXXXXXXXXXXXXXXXXXXXXXXXXXXXXXXXXXXXXXXXXXXXXXXXXXXXX-------------------------XXXXXXXXXXXXXXXXXXXXXXXXXXXXXXXXXXXXXXXXXXXXXXXXXXXXXXXXXXX