------------------------------------------------------------------------------------------------------------------------------------------------------------------------
------------------------------------------------------------------------------------------------------------------------------------------------------------------------
------------------------------------------------------------------------------------------------------------------------------------------------------------------------
------------------------------------------------------------------------------------------------------------------------------------------------------------------------
------------------------------------------------------------------------------------------------------------------------------------------------------------------------
SSS--SSSSS-------------------------------------S?S----S-----------------------------SSS-SSSSSSSD-----------------SSSSSSSSD-------------------S-SSSS---------------------
------------------------------------------------------------------------------------------------------------------------------------------------------------------------
------------------------------------------------------------------------------------------------------------------------------------------------------------------------
------------------------------------------------------------------------------------------------------------------------------------------------------------------------
--------------------XXX--XXX----S---------SS----S----------------S-----------XX---XX--------------------XXX----------S--S-------<>---X--XX------------------------XXX---
--------------------XX---XXX---------------------------------------------XX--XX---XX-------------------XX----XX-----------------[]--XX--XX------------------------XXX---
----------------XXXXXX---XXX---------------------------------------------XXXXXX---XX---------------<>XXXXX---[]-----------------[>--XX--XX------------------<>----XXX---
---------------XXXXXXX---XXX-----------E------------E--E----------------XXXXXXX--XXX---------------[XXXXX----[]--E---------E----[]--XX-XXX-----------E------[-XX-XXXX---
XXXXXXX--XXXXXXXXXXXXXXXXXXXXXXXXXXXXXXXXXXXXXXXXXXXXXXXXXX----XX--------XXXXX---XXXXXXXXX--XXXX--XXXXXXXXXXXXXXXXXXXXXXXXXXXXXXXXXXXXXXXXXXXXXXXXXXXXXXXXXXXXXXXXXXXXXX