------------------------------------------------------------------------------------------------------------------------------------------------------------------------
------------------------------------------------------------------------------------------------------------------------------------------------------------------------
------------------------------------------------------------------------------------------------------------------------------------------------------------------------
------------------------------------------------------------------------------------------------------------------------------------------------------------------------
------------------------------------------------------------------------------------------------------------------------------------------------------------------------
--------------------------------------------------------SS----SS--------------------SS----SS----------------------------------------------------------------------------
------------------------------------------------------------------------------------------------------------------------------------------------------------------------
------------------------------------------------------------------------------------------------------------------------------------------------------------------------
------------------------------------------------------------------------------------------------------------------------------------------------------------------------
-------------------XXXX---XX---------------------XX---XX------------D------XXXX--XXX----DS-----D-------S-S----------------------------XXX--------D--D-----<<>---S-------
-----------------XXXXXX---XX-----------------XX--XX---XX-------------------XXX---XXX------------------------------------------------X-XXX------------------[]-----------
----------------XXXXXXX--XXX-----------------XXXXXX---XX---------------<>-XXXX---XXX---------------<>-------------------------<>--XXXXXXX-X----------------[------------
---------------XXXXXX-X--XXX----------------XXXXXXX--XXX----------E----[]XXXX-X-XXXX---------------[]-------------------------[]--XXXXXXXX-S[E-E-E-----E---[----------E-
XXXXXXXXXXXXXXXXXXXXXXXXXXXXXXXX-----------XXXXXXXX-XXXXXXXXXX---XXXXXXXXXXXXXXXXXXXXXXXXXXXXXXXXXXXXXXXXXXXXXXXXXXXXXXXXXXXXXXXXXXXXXXXXXXXXXXXXXXXXXXXXXXXXXXXXXXXXXXX