------------------------------------------------------------------------------------------------------------------------------------------------------------------------
------------------------------------------------------------------------------------------------------------------------------------------------------------------------
------------------------------------------------------------------------------------------------------------------------------------------------------------------------
------------------------------------------------------------------------------------------------------------------------------------------------------------------------
------------------------------------------------------------------------------------------------------------------------------------------------------------------------
------------------------SSSS-----------------------------S----SSS--------------------------------------------SSSSSSSXSSSSSSS-------------------SS-----------------------
------------------------------------------------------------------------------------------------------------------------------------------------------------------------
---------------------E------------------------------------------------------------------------------------------------------------------------E-------------------------
------------------------------------------------------------------------------------------------------------------------------------------------------------------------
----SSSDS--D--DS---S?S----?S---------S?-D-------XXX---XX-------------------X---------DD-----------D------S--------S-S----------<>-----S------?S--D--D-------<>X---S-S---
---------------------------------------------XXXX----XX-------------------XX---------------------------------------------------[>---------------------------[]----------
--------------------------------------------XXXXX----[]X--------------<>--X-------X--------------------------------------------[]--------<>-----------------[]----------
--------------------------E-----------E----XXXXXX----[]X--------------[]-XXX--X----X--------E-----------------------------E----[]-E------[]--E---E-----EE---[]--EE--EE-E
XXXXXXXXXXXXXXXXXXXXXXXXXXXX-X------XX------XXXXXX--XXXXXXXXXXX-----XXXXXXXXXXXXXXXXXXXXXXXXXXXXXXXXXXXXXXXXXXXXXXXXXXXXXXXXXXXXXXXXXXXXXXXXXXXXXXXXXXXXXXXXXXXXXXXXXXXX