------------------------------------------------------------------------------------------------------------------------------------------------------------------------
------------------------------------------------------------------------------------------------------------------------------------------------------------------------
------------------------------------------------------------------------------------------------------------------------------------------------------------------------
---------X--------------------------------------------------------------------------------------------------------------------------------------------------------------
------------------------------------------------------------------------------------------------------------------------------------------------------------------------
---------XX-----SSS--------------------------------DS-------------------SSS------------------------------SSS----SSS--SSS------------------------------------------------
------------------------------------------------------------------------------------------------------------------------------------------------------------------------
------------------------------------------------------------------------------------------------------------------------------------------------------------------------
------------------------------------------------------------------------------------------------------------------------------------------------------------------------
--------D----------------------------S---------X--X---------------------------XX--XX--S--S--D--D--DS----S-----------SSS------------S---------DS-----DS-------<>---------
----------------------XX----------------------XX--X--------------------------XX---XX------------------------------------------->-----------------------------[]----X----
<>--------------------XXX--------------------XXX------X--------------------XXXX---XX----------------[-------------------------<>-----------------------------[]---XXX---
[]-----------------X-XXXXX-------------------XXX--X----X------------------XXXXX--XXX-E-E-E--E--E----[]------EE----------------[]--E---------------E-E----E-E-[]-EX-XX--E
XXXXXXXXX-XXXXXXXXXXXXXXXXXX------------------XXX---XXXXXXX----XX---XX--XXXXXXX-XXXXXXXXXXXXXXXXXXXXXXXXXXXXXXXXXXXXXXXXXXXXXXXXXXXXXXXXXXXXXXX--XXXX---XXXXXXXXXXXXXXXX