------------------------------------------------------------------------------------------------------------------------------------------------------------------------
------------------------------------------------------------------------------------------------------------------------------------------------------------------------
----------------------------------------------------------------X-------------------------------------------------------------------------------------------------------
---------------------------------------------------------------XX------------------------------------------------------------------------------------X------------------
---------------------------------------------------------------XX-------------------------------------------------------------------------------------------------------
-SSSSSSS-----------------------SS-----------------------------D-SXSX--------?SDSSSSS------------------S-----------------------------------------------------------------
------------------------------------------------------------------------------------------------------------------------------------------------------------------------
----------------------------------------------------------------------------E-------------------------------------------------------------------------------------------
------------------------------------------------------------------------------------------------------------------------------------------------------------------------
-----D------D-------XX--XX---?S------S?-D--------XXXXXXX-----DS-------<>---?S--SS--------D--D-----SS---------------------------------------------------------<>---------
---------------[>--XX---XXX---------------------XXX--XXX--------------[]----------------------------------------------------------X--------------------------[]---------
---------------[]--XX---XXX-----------------XXXXXXX--XXX--------------[]---------------------------]----------------------------XXXX-----X-------------------[]-------X-
[E-E-E----E-E--[]-EXX---XXX-----------E-E---XXXXXXX--XXX-E------------[]--------E--------E--------[]---------EEE----------------XXXX-----X-------------------[]-E----XXX
XXXXXXXXXXXXXXXXXXXXXXXXXXXXXXXX--XXXXXXXXXXXXXXXXXXXXXXXXXXXXXXXXXXXXXXXXXXXXXXXXXXXXXXXXXXXXXXXXXXXXXXXXXXXXXXXXXXXXXXXXXXXXXXXXXXXXXXXXXXXX------------XXXXXXXXX-XXXX