------------------------------------------------------------------------------------------------------------------------------------------------------------------------
------------------------------------------------------------------------------------------------------------------------------------------------------------------------
------------------------------------X-----------------------------------------------------------------------------------------------------------------------------------
----------------------------------XXXX----------------------------------------------------------------------------------------------------------------------------------
-----------------------------------XX-----------------------------------------------------------------------------------------------------------------------------------
-----SSS--------------------------XXXXXX----SSSSSSDSSSSS--SSSSD---------------------SSSSSSSSS---------------------------------------------------------------------------
------------------------------------------------------------------------------------------------------------------------------------------------------------------------
-------------------------------------------E----------------------------------------------------------------------------------------------------------------------------
------------------------------------------------------------------------------------------------------------------------------------------------------------------------
---------------------X--------------------SS----SS----?S-----D----------<>-----XX---------------D------XXX--XX------------------------XX--------------------------X-----
--------------------XX---->--------------------------------------------[[]-----XX----------------------XX-X-XX-------------------XX--XXX--XX----------------------X-----
----------------XXXX-----[>--------------------------------------------[[]----XXXX-----------------<>-XXXXXXXXX------------------XXXXXXX--XX--------------->--X---XX--X-
----------------XXXXX----[]-------------------------E-E----------EE-E--[[]----XXXX-----------EE----[]XXXX-XXXXX------------------XXXXXXX-XXX------------------XX--XX---X
XXXXXXXXXXXXXXXXXXXXXXXXXXXXXXXXXXXXXXXXXXXXXXXXXXXXXXXXXXXXXXXXXXXXXXXXXXXXXXXXXXXXXXXXXXX--XXXXXXXXXXXXXXXXXXXXXXX---XX-------XXXXXXXXXXXX------------------X-X-XXXXXX