------------------------------------------------------------------------------------------------------------------------------------------------------------------------
------------------------------------------------------------------------------------------------------------------------------------------------------------------------
------------------------------------------------------------------------------------------------------------------------------------------------------------------------
------------------------------------------------------------------------------------------------------------------------------------------------------------------------
------------------------------------------------------------------------------------------------------------------------------------------------------------------------
-SSSSSDS---------------------SSSSSSSSD--------------------SSSSD---------------------------------------------------------------------------------------------------------
------------------------------------------------------------------------------------------------------------------------------------------------------------------------
------------------------------E-----------------------------------------------------------------------------------------------------------------------------------------
------------------------------------------------------------------------------------------------------------------------------------------------------------------------
-----D------X--<>---DDS------DS----------------X-X--XX------SSS--------<>----SS--------------------------S--------------D-----S-<<>-S?S----S--------------S-------SS----
---------------[]---------------------------<X--XXXXXX-----------------[]-------------------------------------------------------[[]-------------------------------------
------------X--[]--------<------------------[>-XXXXXXXX----------------[]--------<>----------------------------------------------[]-------------------------------------
-E---E----E-E--[]--------[E-------E-E-E-----[]-XXXXXXXX--E-E-E------E--[]--------[]----------------------------E-----E---E-EE----[]------EEE---------EE-E--E------------
XXXXXXXXXXXXXXXXXXXXXXXXXXXXXXXXXXXXXXXXXXXXXXXXXXXXXXXXXXXXXXXXXXXXXXXXXXXXXXXXXXXXXXXXXX----XXXXXXXXXXXXXXXXXXXXXXXXXXXXXXXXXXXXXXXXXXXXXXXXXXXXXXXXXXXXXXXXXXXXXXXXXX