------------------------------------------------------------------------------------------------------------------------------------------------------------------------
--------------------------------------------------------------------------------------------X---------------------------------------------------------------------------
-------------------------------------------------------------------------------------------XX---------------------------------------------------------------------------
------------------------------------------------------------------------------------------XXXX--------------------------------------------------------------------------
------------------------------------------------------------------------------------------XXXX-------------E------------------------------------------------------------
----------------------SSS----------------------------------SSSS------------------------SSSXXXXXX----------SSSSSS-SSSSSSS-D----------------------------------------------
------------------------------------------------------------------------------------------------------------------------------------------------------------------------
--------------------------------------------------------------------------------------E------------------E--------------------------------------------------------------
------------------------------------------------------------------------------------------------------------------------------------------------------------------------
----SSSDS--D--DS---S----------S--D--D-D-----<>-----------DS------------------XX-XX---DS----------------S?S---------------S--D------XXXX---------------------------------
--------------------------------------------[]---------------------------XXXXXX-XXXX---------------------------------------------XXXXXX--XX-----------------------------
--------------------------------------------[]------XX------------------XXXXXXXXXXXX--------------<>----------------------------XXXXXX---XXX----------------------------
-----------------------------E-E-E--E--E----[]------XE------------------XXXXXXXXXXXX------E-------[]---------------------------XXXXXX-X--XXX------------------XX--------
XXXXXXXXXXXXXXXXXXXXXXXXXXXXXXXXXXXXXXXXXXXXXXXXXXXXXXXXXXXXXXXXX----XXXXXXXXXXXXXXXXXX-XXXXX--XXXXXXXXXXXXXXXXXXXXXXXXXXX-XXXXXXXXXXXXXXXXXXXXX---XXXXXX---XXXXXXXXXXXX