------------------------------------------------------------------------------------------------------------------------------------------------------------------------
------------------------------------------------------------------------------------------------------------------------------------------------------------------------
------------------------------------------------------------------------------------------------------------------------------------------------------------------------
------------------------------------------------------------------------------------------------------------------------------------------------------------------------
-----------------------------------------------------------------------------------------------------------E---E--------------------------------------------------------
---------------------------------------------------------SSSSSSSSDSS------------------------------------?SSSSSSS-SS--SSSSD----------------------------------------------
------------------------------------------------------------------------------------------------------------------------------------------------------------------------
----------------------------------------------------------E----------------------------------------------E--------------------------------------------------------------
------------------------------------------------------------------------------------------------------------------------------------------------------------------------
-----------D--DS-----S--------------D--D--D--------------?S-------------<>---D----------S-S-------<>---SSS----?S-------------------S-------------S--D--D----<>---D------
------------------------------------------------------------------------<]------------------------[]--------------------------------------------------------[]----------
------------------------------------------------------------------------[]-------<>---------------[]--------------------------<]----------------------------[]-------<--
------------------------------------E-------------------------E-E--E----[]-------[]----------E--E-[]----------E---------EE----[]-------------E-E-E-----E----[]-------[]-
XXXXXXXXXXXXXXXXXXXXXXXXXXXXXXXXXXXXXXXXXXXXXXXXXXXXXXXXXXXXXXXXXXXXXXXXXXXXXXXXXXXXXXXXXXXXXXXXXXXXXXXXXXXXXXXXXXXXXXXXXXXXXXXXXXXXXXXXXXXXXXXXXXXXXXXXXXXXXXXXXXXXXXXX
