------------------------------------------------------------------------------------------------------------------------------------------------------------------------
------------------------------------------------------------------------------------------------------------------------------------------------------------------------
--------X---------------------------------------------------------------------------------------------------------------------------------------------------------------
-------XXX--------------------------------------------------------------------------------------------------------------------------------------------------------------
-------XXX------------------------------------------------------X-------------------------------------------------------------------------------------------------------
------XXXXXX----S--------------SSSD----------------------SSSSSSSSDS----------------------------------------------------------------S?SD-SSSS----S-----------------------
------------------------------------------------------------------------------------------------------------------------------------------------------------------------
------------------------------------------------------------------------------------------------------------------------------------------------------------------------
------------------------------------------------------------------------------------------------------------------------------------------------------------------------
--------------------------------SSSXS------<>------XX----DS------S---------XXXX--XXX----SSSDS-----DS----S-S---------SSSDS--D--DS---SSS----?S----------------------S-----
-------------------------------------------[]------XX--------------------XXXXXX--XXX------------------------------------------[-----------------------------------------
-------------------------------------------[]------XXX------------------XXXXXXXXXXXX<-----------------------------------------------------------------------<>-------<>-
-----------------------------E-E-E------E--[]----X-XXX-----------------XXXXXXXX-XXXX[X-E-E-----E--------------E--E-E----------------------E----------EE-E---[]-------[]X
X-XXX-------X----X-XXXXXXXXXXXXXXXXXXXXXXXXXXXXXXXXXXXXXXX-------------XXXXXXXXXXXXXXXXXXXXXXXXXXXXXXXXXXXXXXXXXXXXXXXXXXXXXXXXXXXXXXXXXXXXXXXXXXXXXXXXXXXXXXXXXXXXXXXXX
