------------------------------------------------------------------------------------------------------------------------------------------------------------------------
------------------------------------------------------------------------------------------------------------------------------------------------------------------------
--------X---------------------------------------------------------------------------------------------------------------------------------------------------------------
-------XX---------------------------------------------------------------------------------------------------------------------------------------------------------------
-------XX---------------------------------------------------------------------------------------------------------------------------------------------------------------
SSS--SSSSDXX-----------------SSSSSSS-----------------------SS-------------------------------------------?SD-SSSS----------------SSSD---------SSSSSSSSSSS-----------S----
------------------------------------------------------------------------------------------------------------------------------------------------------------------------
----------------------------------------------------------E-------------------------------------------------------------------------------------------------------------
------------------------------------------------------------------------------------------------------------------------------------------------------------------------
---------------------XX---XX--S-SS----------<>-----XX----DS------S?-D----XXX-XX--X------SSSDS--D--<>---SSS-----S--------------S-------S----------S---------<----D-------
-----------------XX-XXX--XXX----------------[]-----XXX-------------------XXXXXX-XXX---------------[]-------------------------------------------------------[]-----------
----------------XXXXXX---XXX----------------[]-----XXX------------------XXXXXXXXXXX---------------[]------------------------------------------------------[[]-----------
---------------XXXXXX----XXX-E-------E-E----[]---X-XXX--------E---E-E---XXXXXXXXXXX--E-E-E--------[]----------E---X------------------------E-E------------[[]-E------E--
XXXXX---------XXXXXXXXXXXXXXXXXXXXXXXXXXXXXXXXXXXXXXXXXXXXX---XXX--XXXXXXXXXXXXXXXXXXXXXXXXXXXXXXXXXXXXXXXXXXXXXXXXX---XXXXXXXXXXXXXXXXXXXXXXXXXXXXXXXXXXXXXXXXXXXXXXXXX
