------------------------------------------------------------------------------------------------------------------------------------------------------------------------
------------------------------------------------------------------------------------------------------------------------------------------------------------------------
------------------------------------------------------------------------------------------------------------------------------------------------------------------------
------------------------------------------------------------------------------------------------------------------------------------------------------------------------
-------------------------------------------------------------------------------------------------------------------------------------------------------------------E---E
--------------------------------------------------------SSSSSSSSSD---------------------?S------------------S------------------------------------------------------SSSSSS
------------------------------------------------------------------------------------------------------------------------------------------------------------------------
-----------------------------------------------------------------------------------------------------------------------------------------------------------------E------
------------------------------------------------------------------------------------------------------------------------------------------------------------------------
----------------------XXXX------------------------------------------D-------XX-------?S------S?------------XX--------------------XXX-XX--XXX-------------------S?S----?S
--------------------XXXXXX------------------[>------------------------------X----X>---------------->-------XX--------------------XX--XX--XXX----------------------------
-------------------XXXXXXXX-----------------[]-------------------------<>--XX----X]---------------<>------XXX--------------------XXXXXX--XXX--------------<-------------
------------------XXXXXXXXXX---------E-E----[]-------EEE----------E-E--[]-EXX----[]-----------E-E-[]------XXX-------------------XXXXXXX--XXX--------------[]----------E-
XXXXXXXXXXXXXXXXXXXXXXXXXXXXXXXXXXXXXXXXXXXXXXXXXXXXXXXXXXXXXXXXXXXXXXXXXXXXXXXXXXXXXXXXXXXXXXXXXXXXXXXXXXXXXXXX---------------X-XXXXXXXXXXXXXXXXXXXXXXXXXXXXXXXXXXXXXXX
