------------------------------------------------------------------------------------------------------------------------------------------------------------------------
------------------------------------------------------------------------------------------------------------------------------------------------------------------------
------------------------------------X-----------------------------------------------------------------------------------------------------------------------------------
-----------------------------------XXX----------------------------------------------------------------------------------------------------------------------------------
-----------------------------------XXX----------------------------------------------------------------------------------------------------------------------------------
---SS?D----D-------------------SSSDXXXXX-------------------------------------------------------------------------------------------------------SSSS---------------------
------------------------------------------------------------------------------------------------------------------------------------------------------------------------
--E---------------------------E-----------------------------------------------------------------------------------------------------------------------------------------
------------------------------------------------------------------------------------------------------------------------------------------------------------------------
-----D--D-------<>---X--XX-X-DS-------------<>-------------------------------------------D--D-------<----X-XXX-------D----------<>--S?SS---S---------S?-D------XXXXXXX--
->--------------[]---X--XXXX----------------[]--------------------------------------->-------------[]---X--XXX------------------[]----------------------------XXX-XXXX--
<]--------------[]--XX--XXXX----------------[]-------<----------------<>------------<]--------------<>-XXXXXXXX-----------------[]------------------------<<XXXXX-XXXXX-
[]-E-E-----EE---[]--XX--XXXX------E---------[]--E----E]E--------------[]--E---------[]-E-E----------[]-XXXXXXXX--X---E---E-EE----[--------E-----------E----XXXXXXXXXXXX-
XXXXXXXXXXXXXXXXXXXXXXXXXXXXXXX--XXXX--XXXXXXXXXXXXXXXXXXXXXXXX--XXXXXXXXXXXXXXXXXXXXXXXXXXXXXXXXXXXXXXXXXXXXXXXXXXXXXXXXXXXXXXXXXXXXXXXXXXXXXXXXXXXXXXXXXXXXXXXXXXXXXXX
