------------------------------------------------------------------------------------------------------------------------------------------------------------------------
------------------------------------------------------------------------------------------------------------------------------------------------------------------------
------------------------------------------------------------------------------------------------------------------------------------------------------------------------
--------XX--------------------------------------------------------------------------------------------------------------------------------------------------------------
-------X-X--------------------------------------------------------------------------------------------------------------------------------------------------------------
---------XX------------S---------------------------S----------------------SSS-----S---------SD--------------SSSS--------------------------------------------------------
------------------------------------------------------------------------------------------------------------------------------------------------------------------------
------------------------------------------------------------------------------------------------------------------------------------------------------------------------
------------------------------------------------------------------------------------------------------------------------------------------------------------------------
-DS------S-------<X---X--------------S?-D-----XX-XXXXX----S--S--------SS----S------S-------------------S?S----------SS-D-----------D-------------------------<>---------
-----------------[]---<X---------------------XXXXXXXX--X-----------------------------------------------------------------------------------------------------[]---------
-----------------[]---X----------------------XXXXXXXXXX-------------------------------------------[]--------------------------<>-------XX--------------------[]---------
------E------E-E-[]---X----E----------E----XXXXXXXXXXXXS--------E--E--------------------------E---[]-----------E--------------[]-------XX--------------------[]-E----EXX
-------X-------X-XX-----XXXXXX-----XX--------XXXXXXXXXXXXXXXXXXXXXXXXXXXXXXXXXXXXXXXXXXXXXXXXXXXXXXXXXXXXXXXXXXXXXXXXXXXXXXXXXXXXXXXXXXXXXXXXXXXXXXXX--XXXXXXXXXXXXXXXXX
