------------------------------------------------------------------------------------------------------------------------------------------------------------------------
------------------------------------------------------------------------------------------------------------------------------------------------------------------------
------------------------------------------------------------------------------------------------------------------------------------------------------------------------
------------------------------------------------------------------------------------------------------------------------------------------------------------------------
------------------------------------------------------------------------------------------------------------------------------------------------------------------------
----------------------------SSSS-SSSSD----------------------------------------SSSS-----D-------------------------------------------------------?------------------------
------------------------------------------------------------------------------------------------------------------------------------------------------------------------
------------------------------------------------------------------------------------------------------------------------------------------------------------------------
------------------------------------------------------------------------------------------------------------------------------------------------------------------------
----SSS----D-------S?S---------------------------S-----------------D--D-----------------SDS-D-----SS<---S-SSS------------S-------<>---S-S--------D--D------<>-------X---
----------------------------------------------------------------------------------------------------[----------------------------[]---------->-------------[]------XX---
--------------[]--------------------------------------------------------------------<]--------------[]---------------------------[]---------<]-------------[]]-----XXX--
-E------------[]----------E---------------------------------------------------------[]-E-E-----EE---------------------------EE---[]-EE-----E[]-E-E-----EE---[]-----XXX--
XXXXXXXXXXXXXXXXXXXXXXXXXXXXXXXXXXX--XXXXXXXXXXXXXXXXXXXXXXXXXXX-XXXXXXXXXXXXXXXXXXXXXXXXXXXXXXXXXXXXXXXXXXXXXXXXXX----XX---XXXXXXXXXXXXXXXXXXXXXXXXXXXXXXXXXXXXXXXXXXXX
