------------------------------------------------------------------------------------------------------------------------------------------------------------------------
------------------------------------------------------------------------------------------------------------------------------------------------------------------------
----------------------------------------------------------------X-------------------------------------------------------------------------------------------------------
---------------------------------------------------------------XXX------------------------------------------------------------------------------------------------------
----------------------------------------------------------------XX------------------------------------------------------------------------------------------------------
---SSSD------------------------SS------------------------------XXXX----SSSS---------------------------------------------------------------------------------------------
------------------------------------------------------------------------------------------------------------------------------------------------------------------------
--E---------------------------E-----------------------------------------------------------------------------------------------------------------------------------------
------------------------------------------------------------------------------------------------------------------------------------------------------------------------
X?S-----?SD------<>----------?S--D--DSD-----------XXXX---------------------------------------------------------------------------XX---XXXX---------------------X--XXX---
-----------------[]-----------------------------XXXXXX-X-----------------------------------------------X------XX-----------------[X--XXXXX--------------------XXX-XXX---
-----------------[]---------X>--------------<>-XXXXXXXXX--------------------XX---X-----------------<>--X-----XXX-----------------[]-XXXXXXX----------------<>-XXX-XXXX--
------E-E----E-E-[]---------[]---E----E-----[]XXXXXXXXXX-------------------XX---XXXX---------------[]-XX----XXXX-------------E---[XXXXXXXXXX--------EE-----[]XXXXXXXXX--
XXXXXXXXX--XXXXXXXXXXXXXXXXXXXXXXXXXXXXXXXXXXXXXXXXXXXXXXXXXXX----XXXX-XXXXXXXXXXXXXXXXXXXXXXXXXXXXXXXXXXXXXXXXXXXXXXXXXX--XXXXXXXXXXXXXXXXXXXXXXXXXXXXXXXXXXXXXXXXXXXXX
