------------------------------------------------------------------------------------------------------------------------------------------------------------------------
------------------------------------------------------------------------------------------------------------------------------------------------------------------------
--------------------------------------------------------------------------------------------X------------------------------------------------------XX-------------------
-------------------------------------------------------------------------------------------XXX-----------------------------------------------------XX-------------------
-------------------------------------------------------------------------------------------XXX-----------------------------------------------------XX-------------------
SSSSSSSS----------------------XSSSD---------------------SSSSXSSSSSSX--------------S--------XXXX-----SSSS------------------------------------------SXXXXX---SSS----------
------------------------------------------------------------------------------------------------------------------------------------------------------------------------
------------------------------E-----------------------------------------------------------------------------------------------------------------------------------------
------------------------------------------------------------------------------------------------------------------------------------------------------------------------
--D----------------X-XX-XX---?S--D--DS-----<>>---DS-----------------------------------------------------------X------SSDS--D---------D--------------------------XX------
-----------------XX-XXX-XX-----------------[>]------------------------->--------------------------------------XX-----------------------------------------------XXX--XXX-
----------------XXXXXXXXXXX----------------[]]-------<-----------------][--------<>----------------------X---XXX---------------<>--------<>-------------------XXXX--XXX-
--------E-------XXXXXXXXXXXX[E-E-E----E-E--[]--------EE-----------E-E-[]-E-------[]--------------------XX----XXX[X-E-E---------[]--------[]-----------------XXXXXXX-XXXX
XXXXXXXXXXXXXXXXXXXXXXXXXXXXXXXXXXXXXXXXXXXXXXXXXXXXXXXXXXXXXXXXXXXXXXXXXXXXXXXXXXXXX-XXX-------X--XXXXXXXX-XXXXXXXXXXXXXXXXXXXXXXXXXXXXXXXXXXXX---X--XXXXXXXXXXXXXXXXXX
