------------------------------------------------------------------------------------------------------------------------------------------------------------------------
------------------------------------------------------------------------------------------------------------------------------------------------------------------------
------------------------------------------------------------------------------------------------------------------------------------------------------------------------
------------------------------------------------------------------------------------------------------------------------------------------------------------------------
------------------------------------------------------------------------------------------------------------------------------------------------------------------------
----------------SSSS-----------SSSD-------------------------------------SD----------------------------------------------------------------------S-----------------------
------------------------------------------------------------------------------------------------------------------------------------------------------------------------
------------------------------------------------------------------------------------------------------------------------------------------------------------------------
------------------------------------------------------------------------------------------------------------------------------------------------------------------------
--------------S---------X-----S-----------------------------------------------X---XX------------------------------------------D-----------------------------------------
------------------------XX---------------------------------------------------X----XX------------------------------------------------------------------------------------
-----------------[]-XX--XX-------------------<-------<-------------------X---X----XX----------------------------------------------------------------------<>--X------X--
-----------E-E---[]-XX-XXXX------------------]-------[]------------------XXXX----XXX-------------------------------------------E-----------E----------E-E-[]--XX----X---
XXXXXXXXXXXXXXXXXXXXXXXXXXXXXXXXXXXXXXXXXXXXXXXXXXXXXXXX-----------------X-XXX---XXXXXXXXXXXXXXXXXXXXXXXXXXXXXXXXXXX-XX----XXXXXXXXXXXXXXXXXXXXXXXXXXXXXXXXXXXXXXXXXXXXX
