------------------------------------------------------------------------------------------------------------------------------------------------------------------------
------------------------------------------------------------------------------------------------------------------------------------------------------------------------
------------------------------------------------------------------------------------------------------------------------X-----------------------------------------------
-----------------------------------------------------------------------------------------------------------------------XX-----------------------------------------------
-----------------------------------------------------------------------------------------------------------------------XX-----------------------------------------------
-------------------------------------------------------------------------------------SSSSSSSSS---------------------SSSDSXXS---------------S-----------------------------
------------------------------------------------------------------------------------------------------------------------------------------------------------------------
------------------------------------------------------------------------------------------------------------------------------------------------------------------------
------------------------------------------------------------------------------------------------------------------------------------------------------------------------
---------------------XX--XXX----SSSDS--D--DS----SSSS---S-----SS-S--------------XX-------S----------<>---SSSS---S---------S---------SDS----------XDS-D--D--D<>--SS-------
-----------------XX-XXX--XXX------------------------------------------------X--XX------------------[]--------------------------]---------------------------[]-----------
----------------XXXXXXX--XXX--------------------------------------------<---X-XXXX-----------------[]-------------------------[]------------<]-------------[------------
---------------XXXXXXXX--XXX-E-E-E---E-E-----------------X-E-E----------]--XXXXXXX-----------E--E--[]---------E-----------E-E-[]------------[]-E-E----------------------
-----------------XXXXXX-XXXXXXXXXXXXXXXXXXXXXXXXXXXXXXXXXXXXXXXXXXXXXXXXXXXXXXXXXXXXXXXXXXXXXXXXXXXXXXXXXXXXXXXXXXXXXXXXXXXXXXXXXXXXXXXXXXXXXXXXXXXXXXXXXXXXXXXXXXXXXXXX
