------------------------------------------------------------------------------------------------------------------------------------------------------------------------
------------------------------------------------------------------------------------------------------------------------------------------------------------------------
----------------------------------------------------------------------------------------------------------------------------------------------------X-------------------
----------------------------------------------------------------------------------------------------------------------------------------------------X-------------------
------------------------------------------------------------------------------------------------------------------------------------------------------------------------
-----------------------------------------------------------SSSS---------------------SSS--SSS--------------SSSS-SSSS--SSS-------------------------------------S----SSSS--
------------------------------------------------------------------------------------------------------------------------------------------------------------------------
------------------------------------------------------------------------------------------------------------------------------------------------------------------------
-------------------------------------------------------------------------------------------------------------------------------------------X----------------------------
--------D-----SX<>--S-----------SSSDS---------------------S-------------<>-----------------------------S---------------------------XXXX--XXX----------------------------
----------------[]------------------------------------------------------[]--------------------------------------------------------XXXXX--XXX------------------X---------
----------------[]-------------------------<>---------------------------[]-------------------------<>--------------------------XXXXXXXX--XXX------------------X---------
-X-E-E--EE-E-----]-----EEE-E-X-------------[]-------------------EE-E----[]------EE-----------------[]--------E-----------------XXXXXXXX--XXX----------------------------
XXXXXXXXXXXXXXXXXXXXXXXXXXXXXXXXXXXXXXXXXXXXXXXXXXXXXXXXXXXXXXXXXXXXXXXXXXXXXXXXXXXXXXXXXXXXXXXXXXXXXXXXXXXXXXXX---X------------XXXXXXX-XXXX------------------------XXXX
