------------------------------------------------------------------------------------------------------------------------------------------------------------------------
------------------------------------------------------------------------------------------------------------------------------------------------------------------------
------------------------------------------------------------------------------------------------------------------------------------------------------------------------
------------------------------------------------------------------------------------------------------------------------------------------------------------------------
------------------------------------------------------------------------------------------------------------------------------------------------------------------------
-----------------SSS------------------------------------------------------------------------------------------------------------------------SSSSSSSSS-------------------
------------------------------------------------------------------------------------------------------------------------------------------------------------------------
------------------------------------------------------------------------------------------------------------------------------------------------------------------------
------------------------------------------------------------------------------------------------------------------------------------------------------------------------
--------D-----SS-------XXX----------------D-------S----------D--DS---------X-XXXXXXX---------------------XXXXX-X-------------------X----X----------------------XXX----X-
---------------------XXXXX-X----------------------------->-----------------XX-XXXXXX-----------------XX-XXX-XX-X-------------------XX--XX----------------------XX----XX-
----------------->--XXXXXXXX-----------------<>---------<>-------------<>-XXXXXXXXXX-----------------XXXXXXXXXXX--------------<<>-XXX--XXX-----------------<>XXXX----XX-
-----------E-------XXXXXXXXX-----------------[]---------[]---E----E----[]-XXXXXXXXXX----------------XXXXXXXXXXXX---------------[]XXXX-XXXX-----------------[XXXXX---XXX-
XXXXXXXXXXXXXXXXXXXXXXXXXXXXXXXXXXXXXXXXXXXXXXXXXXXXXXXXXXXXXXXXXXXXXXXXXXXXXXXXXXXXXXXXXXXXXXXXXXXXXXXXXXXXXXXXXXXXXXX--XXXXXXXXXXXXXXXXXXXXXXXXXX--XXXXXXXXXXXXXXXXXXX
