------------------------------------------------------------------------------------------------------------------------------------------------------------------------
------------------------------------------------------------------------------------------------------------------------------------------------------------------------
------------------------------------------------------------------------------------------------------------------------------------------------------------------------
------------------------------------X-----------------------------------------------------------------------------------------------------------------------------------
------------------------------------X-----------------------------------------------------------------------------------------------------------------------------------
-------------------------------------XX------------------------S------------------------------------SSS--SSSS----------------------------------SSSS---------------------
------------------------------------------------------------------------------------------------------------------------------------------------------------------------
------------------------------------------------------------------------------------------------------------------------------------------------------------------------
------------------------------------------------------------------------------------------------------------------------------------------------------------------------
-----------------<X---X----------------------<>--------------------------------------------------------X----X--------D---------<>------XX----DS------S?--------XXX------
-----------------XX--------------------------[]---------------------------------------------------------X-XXX------------------[]------XX--------------------XXXX---XX--
-----------------[]--------------------------[]-----------------------<>------------------------------XXX-XXXX--<>-------------[------XXX-------------------XXXXX--XXX--
---------------E-[]--------X------------E----[]-E----EEE--------------[]------------------------------XXXXXXXX--[X-E-E---EE-E----------XX---------------E--XXXXXX-XXXXX-
--------------------------X-XXXXXXXXXXXXXXXXXXXXXXXXXXXXXXXXXXXXXXXXXXXXXXXXXXXXXXXXXXXXXXXXXXXXXXXXXXXXXXXXXXXXXXXXXXXXXXXXXXXXXXXXXXXXXXXXXXXXXXXXXXXXXXXXXXXXXXXXXXXX
