------------------------------------------------------------------------------------------------------------------------------------------------------------------------
------------------------------------------------------------------------------------------------------------------------------------------------------------------------
------------------------------------------------------------------------------------------------------------------------------------------------------------------------
------------------------------------------------------------------------------------------------------------------------------------------------------------------------
------------------------------------------------------------------------------------------------------------------------------------------------------------------------
---SSS--------------------------------------------------------------------------------------------------------------------------------------S---------------------------
------------------------------------------------------------------------------------------------------------------------------------------------------------------------
--E---------------------------------------------------------------------------------------------------------------------------------------------------------------------
------------------------------------------------------------------------------------------------------------------------------------------------------------------------
-DS------SD------XX--XX-XX-----------S----------------------SDS-------<>----SSSS--------------------------S----------SSDS--D--DS----S-SS-------------------------SS-----
-----------------XX--XXXXX-X------------------------------------------[]--------------------------------------------------------[---------------------------------------
-----------------XXXXXXXXXXX------------------X-----------------------[]-----------------------------<>-------------------------[]--------------------------------------
------E-E-E-----X]XXXXXXXXXX-----------------XXX--------[X-E-E----E-E-[]----------E------------E----[[]--------E-E-E-------E----[]--------E----------E------------------
XXXX-XXXX--XXXXXXXXXXXXXXXXXXXXX-XXXXXXXXX--XXXXX-XXXXXXXXXXXXXXXXXXXXXXXXXXXXXXXXXXXXXXXXXXXXXXXXXXXXXXXXXXXXXXXXXXXXXXXXXXXXXXXXXXXXXXXXXXXXXXXXXXXXXXXXXXXXXXXXXXXXXX
