------------------------------------------------------------------------------------------------------------------------------------------------------------------------
------------------------------------------------------------------------------------------------------------------------------------------------------------------------
--------------------------------------------------------------------------------------------X---------------------------------------------------------------------------
-------------------------------------------------------------------------------------------XX---------------------------------------------------------------------------
-------------------------------------------------------------------------------------------XX---------------------------------------------------------------------------
-------------------------------SSSD------------------------SSSD---------------------SSS--SSSSDX-------------------------------------------------------------------------
------------------------------------------------------------------------------------------------------------------------------------------------------------------------
----------------------------------------------------------E-------------------------------------------------------------------------------------------------------------
------------------------------------------------------------------------------------------------------------------------------------------------------------------------
---------------------X---XXX-----D--D--------------------?S--D---S--------------X----------------------------------------S-------<-----XX-------------------------------
---------------------XX--XXX----------------<--------X-------------------------XX------------------------------------------------[]----X--------------------------------
-----------------<>-XXX-XXXX---------------[<>-------<>-----------------------XXX----------------------------<>------------------[]---XX--------------------------------
---------E-E-----[]XXXX-XXXX[]-E-E------E--[]]------[[]-----------E-----]-----XXX-----------------------------]--------------E-E-[]-XXXXX--E---------------------------X
XXXXXXXXXXXXXXXXXXXXXXXXXXXXXXXXXXXXXXXXXXXXXXXXXXXXXXXXXXXXXXXXXXXXXXXXXXXXXXXXXXXXX-XXXX----X----XXXXXXX--XXXXXXXXXXXXXXXXXXXXXXXXXXXXXXXX--------------------X----XXX
