------------------------------------------------------------------------------------------------------------------------------------------------------------------------
------------------------------------------------------------------------------------------------------------------------------------------------------------------------
----------------------------------------------------------------XX------------------------------------------------------------------------------------------------------
----------------------------------------------------------------XX------------------------------------------------------------------------------------------------------
---------------------------------------------------------------XXXX-----------------------------------------------------------------------------------------------------
------SSSD------------SSSSSS---?S--------------------------------XXX---------SD-----S----SSS----------------------------------------------------------------------------
------------------------------------------------------------------------------------------------------------------------------------------------------------------------
---------------------E--------------------------------------------------------------------------------------------------------------------------------------------------
-----------------------------------------------------------------------------------------------------------------------------------------------------------------------X
-------------------S-S----------XDS-S------<>-------XX-------------------<>-------------S----------------DS--------------------------XX--XXX---------------------XX--XXX
----------------------------X>-------------[]------XXX-------------------[--------------------------]-------------------------------XXX--XXX-----------------X--XXX--XXX
--------------<>------------<]-------------[]--X---XXX--------------------]------------------------[]--------------------------->--XXXX-XXXX----------------XXXXXXX--XXX
----------E---[]------------[]-E-E------E--[]---X--XXX---------------E-E-----------E---------E--E--[]---------E-----------------]XXXXXX-XXXX----------------XXXXXXX--XXX
XXXXX-------XXXXXXXXXXXXXXXXXXXXXXXXXXXXXXXXXXXXXXXXXXXXXX-----X----<X-X-X-------XXXXXXXXXXXXXXXXXXXXXXXXXXXXXXXXXXXXXXXXXXXXXXXXXXXXXXXXXXXXXXX---XX-----XXXXXXXXXXXXXX
