------------------------------------------------------------------------------------------------------------------------------------------------------------------------
------------------------------------------------------------------------------------------------------------------------------------------------------------------------
------------------------------------------------------------------------------------------------------------------------------------------------------------------------
--------XX--------------------------------------------------------------------------------------------------------------------------------------------------------------
------------------------------------------------------------------------------------------------------------------------------------------------------------------------
----S----XX--------------------------------------------------------------------------SSSSSDSSSSD-------------------SSSSS------------------------------------------------
------------------------------------------------------------------------------------------------------------------------------------------------------------------------
--E---------------------------------------------------------------------------------------------------------------------------------------------------------------------
------------------------------------------------------------------------------------------------------------------------------------------------------------------------
-DS------S-------<>---S---------------------------S---------------------------XXX------------------<>------XX---------------D--------S----------SSS-------DS----SS----?S
-----------------[]----------------------------------------------------------XX----X---------------[]------XX-----------------------------------------------------------
-----------------[]---------------------------------------------------------XXX---XX---------------[]-----XXX------------------[>--------<>-----------------------------
------E-----EE-E-[]-E----EE------------------------------------------------XXXX--XXX---------------[]------XX------------EE-E--[]-E------[]--E-------E-E--------------E-
XXX---XXX--XXXXXXXXXXXXXXXXXXXX----XX---XXXXXXXXXXXXXXXXXXXXXXXXXXXXXXXXXXXXXXXXXXXXXXXXXXXXXXXXXXXXXXXXXXXXXXXXXXXXXXXXXXXXXXXXXXXXXXXXXXXXXXXXXXXXXXXXXXXXXXXXXXXXXXXX
