------------------------------------------------------------------------------------------------------------------------------------------------------------------------
------------------------------------------------------------------------------------------------------------------------------------------------------------------------
------------------------------------------------------------------------------------------------------------------------------------------------------------------------
------------------------------------------------------------------------------------------------------------------------------------------------------------------------
------------------------------------------------------------------------------------------------------------------------------------------------------------------------
---SSSD----------------------------------------------------SS-----------------------SSS--SSS----------------------------------------------------------------------------
------------------------------------------------------------------------------------------------------------------------------------------------------------------------
------------------------------------------------------------------------------------------------------------------------------------------------------------------------
------------------------------------------------------------------------------------------------------------------------------------------------------------------------
-----SS-D------<>-------X-----------D--------------XX----DS---------------X---X------------------------XXXX-------------------S------------------------------<----XX--XX
---------------[]------XXX-------------------------XX--------------------XX---XX-----------------------XX-----X----------------------------------------------[---XX---XX
---------------[]-----XXXX-------------------<]---XXX--------------------XX---XXX-X----------------<>XXXX----XXX---------------------------------------------[]--XX---XX
[E-E-E-----E---[]----XXXXX-------------E-----[]--XXXXX-------------------[XXXXXXXXXX---------------[]XXX--X-XXXX---------------------------E-----------------[]XXXX--XXX
XXXXXXXXXXXXXXXXXXXXXXXXXXX-XXXXXXXXXXXXXXXXXXXXXXXXXXXXXXX---XXX---XXXXXXXXXXXXXXXXXXXXXXX-XXXXXXXXXXXXXXXXXXXXXXXX--------XX-XXX--------XXXXXX--------XXXXXXXXXXX-XXXX
