------------------------------------------------------------------------------------------------------------------------------------------------------------------------
------------------------------------------------------------------------------------------------------------------------------------------------------------------------
------------------------------------------------------------------------------------------------------------------------------------------------------------------------
------------------------------------------------------------------------------------------------------------------------------------------------------------------------
------------------------------------------------------------------------------------------------------------------------------------------------------------------------
---SSSD--DSD-----------------------------------S?-------S----------------------------------------------------------?SSD-------------------------------------------------
------------------------------------------------------------------------------------------------------------------------------------------------------------------------
------------------------------------------------------------------------------------------------------------------------------------------------------------------------
------------------------------------------------------------------------------------------------------------------------------------------------------------------------
----------------<>------X-----------------SS----S-S?S---------------------------------S-----------SS-------XX-------SDS-----------------X--------D-------------X-XX-----
----------------[]---X--XX-------------------------X-------------------------------------------------------XX------------------>-------XX---->-----------------XX-X-XXX-
----------------[]--XXX-XXXX-----------------------X------------------------------------------------------XXX-----------------[[]------XXX--<>--------------<XXXX-XXXXXX
----------------[]--XX--XXXX---------E-E---E-------EX----------------------------------------------------XXXX--E-E-------EE-E-[[]-E----XXX--[]-E-E----------XXXXX-XXXXXX
XXXXXXXXXXXXXXXXXXXXXXXXXXXXXXXXXXXXXXXXXXXXXXXXXXXXXXXX-----------------------XXXXXXXXXXXXXXXXXXXXXXXXXXXXXXXXXXXXXXXXXXXXXXXXXXXXXXXXXXXXXXXXXXXXXXXXXXXXXXXXXXXXXXXXX
