------------------------------------------------------------------------------------------------------------------------------------------------------------------------
------------------------------------------------------------------------------------------------------------------------------------------------------------------------
------------------------------------------------------------------------------------------------------------------------------------------------------------------------
------------------------------------------------------------------------------------------------------------------------------------------------------------------------
------------------------------------------------------------------------------------------------------------------------------------------------------------------------
---SSSSS-----------------------D---------------------------SS--------------------------SSSDS-----------------------?------------------------S---------------------------
------------------------------------------------------------------------------------------------------------------------------------------------------------------------
----------------------------------------------------------E-------------------------------------------------------------------------------------------------------------
------------------------------------------------------------------------------------------------------------------------------------------------------------------------
--------------------------------XDS--------<>------------?S--D--D-D-----<>---X--XX----S--D--D----------XXX---X-------D------------------X----------------------X-XX---XX
-------------------------------------------[]------------>--------------[]--XX-XXX---------------------XX---XX-----------------[]------XXX-------------------XXX-XX---XX
--------------<>-------X----<>-------------[]--------<>-<]--------------[>--XX-XXXX----------------<>-XXX--XXX-----------------[]------XXX-------------------XXXXXX---XX
----------E---[]-------XX---[]-E-E----E-E--[]-E------[]-[]-E-E-----E----[]-XXXXXXXXS--------E------[]XXXX-XXXX--EE-E-E----E-E--[]------XXX------------------XXXXXXX--XXX
XXXXXXXXXXXXXXXXXXXXXXXXXXXXXXXXXXXXXXXXXXXXXXXXXXXXXXXXXXXXXXXXXXXXXXXXXXXXXXXXXXXXXXXXXXXXXXXXXXXXXXXXXXXXXXXXXXXXXXXXXXXXXXXXXXXXXXXXXXXX-----------------XXXXX--XXXX
