------------------------------------------------------------------------------------------------------------------------------------------------------------------------
------------------------------------------------------------------------------------------------------------------------------------------------------------------------
--------X-------------------------------------------------------------------------------------------------------------------------------------------X-------------------
-------XX-----------------------------------------------------------------------------------X-------------------------------------------------------XX------------------
-------XX-----------------------------------------------------------------------------------X------------------------------------------------------X-X------------------
SSSSXSSSSSXX--------------------------------------------------------------------------------SDX---------------------S---------------------------------X-----------------
------------------------------------------------------------------------------------------------------------------------------------------------------------------------
------------------------------------------------------------------------------------------------------------------------------------------------------------------------
------------------------------------------------------------------------------------------------------------------------------------------------------------------------
-------------------XX-----------SSSD---D-------S-S----------SSSDS--D--DS-----------------------------XXX---------DS------SD----------XX-XXXX--------------S--<>---------
------------------XX---------------------------------------------------------------------------------XX--------------------------XX--XX--XXX-----------------[]---------
---------------<XXXX-----<>----------------<>--------------------------------------X----------------XXXX-----<>------------------XXXXXX--XXX-----------------[]---------
---------------XXXXX-----[]----------------[]--------------------------------------X---------------XXXXX-----[]-------------E---XXXXXXX--XXX-------------E-E-[]--------E
XXXXXX---XX---XXXXXXXXXXXXXXXXXXXXXXXXXXXXXXXXXXXXXXXXXXXXXXXXXXXXXXXXXXXXXXXXXXXXXXXXX------------XXXXXXXXXXXXXXXX---XXX--XXXXXXXXXXXXXXXXXX-----------XXXXXXXXX----XXX
