------------------------------------------------------------------------------------------------------------------------------------------------------------------------
------------------------------------------------------------------------------------------------------------------------------------------------------------------------
------------------------------------------------------------------------------------------------------------------------------------------------------------------------
------------------------------------------------------------------------------------------------------------------------------------------------------------------------
------------------------------------------------------------------------------------------------------------------------------------------------------------------------
------------------------SSSS----------------------------SSS--SSSS--------------------SSSSSSS------------------------------------------SSSSSS----------------SSS---------
------------------------------------------------------------------------------------------------------------------------------------------------------------------------
-------------------------------------------------------------------------------------------------------------------------------------E----------------------------------
------------------------------------------------------------------------------------------------------------------------------------------------------------------------
-----D--------->---S------------SDS-----D----------------------------------XXXX------------------------X--X------------------------S?S--------------------DS------------
--------------[>---------------------------->-----------------------------XXX-----X--------------------X----------------------------------------------------------------
--------------[]---------------------------<>--------<>----------------<XXXX-----XX----------------<>-XX----------------------------------------------------------X-----
----------E---[]--E----------X-------EE-E--[]-E------[]----------------XXXXX-----XX----------------[]XXX----------------------------------------------------------X----X
XXXXXXXXXXXXXXXXXXXXXXXXXXXXXXXXXXXXXXXXXXXXXXXXXXXXXXXXXXXXXX---XXXXXXXXXXXXXXXXXXXXXXXXXXXXXXXXXXXXXXXXXXXXXXXXXXXXXX--XXXXXXXXXXXXXXXXXXXXXXXXXX--XXXXXXXXXXXXXXXXXXX
