------------------------------------------------------------------------------------------------------------------------------------------------------------------------
------------------------------------------------------------------------------------------------------------------------------------------------------------------------
------------------------------------------------------------------------------------------------------------------------------------------------------------------------
------------------------------------------------------------------------------------------------------------------------------------------------------------------------
------------------------------------------------------------------------------------------------------------------------------------------------------------------------
--------------------------------------------SSSSSSSS-SSS---------------------------------------------------------------------------D------------------------------------
------------------------------------------------------------------------------------------------------------------------------------------------------------------------
------------------------------------------------------------------------------------------------------------------------------------------------------------------------
------------------------------------------------------------------------------------------------------------------------------------------------------------------------
-----------------------XX-----------------S----------------------------------D----------------------------X----------SSXS-----<<>---S-SS---S-DS--------D----------XXXX--
--------------->------XXX------------------------------------------------]----------------------------------------------------[[]-------------------------------XXXXXX-X
<>------------<>------XXX-----------------------------------------------[]--------------------------------X-----<>-------------[]--------------------------->--XXXXXXXXX
[]---E----E---[]--EX--XXXX-X-------------------------------------E--E---[]]------EE-------------------XX--X----X[]-E-E------E--[]---------E---------E-------]-XXXXXXXXXX
XXXXXXXXXXXXXXXXXXXXXXXXXXXXXXXXXXXXXXXXXXXXXXXXXXXXXXXXXXXXXXXXXXXXXXXXXXXXXXXXXXXXXXXXXXXXXXXXXXXXXXXXXXXXXXXXXXXXXXXXXXXXXXXXXXXXXXXXXXXXXXXXXXXXXXXXXXXXXXXXXXXXXXXX
