------------------------------------------------------------------------------------------------------------------------------------------------------------------------
------------------------------------------------------------------------------------------------------------------------------------------------------------------------
------------------------------------------------------------------------------------------------------------------------------------------------------------------------
------------------------------------------------------------------------------------------------------------------------------------------------------------------------
------------------------------------------------------------------------------------------------------------------------------------------------------------------------
-----------------SS--SSS-------SSSSSSDS------------S----S------S--------------------------------------------SSSSSS---SSS------------------------------------------------
------------------------------------------------------------------------------------------------------------------------------------------------------------------------
------------------------------------------------------------------------------------------------------------------------------------------------------------------------
------------------------------------------------------------------------------------------------------------------------------------------------------------------------
--------------S---------S------------S?---------------------------------->------------S-SS--S--D--D----S?S------------------D--------XX--XXX----------------------------
------------------------------------------------------------------------<]---X--XXX----------------------------------------------XXXXXX--XXX----------------------------
------------------------------------------<>--X-------------------------[]---X--XXX---------------------------------------------XXXXXXX--XXX----------------------------
---------------E--------E-------------E---[]-XX-----XE-----------E-E----[]--XX--XXXX-E------E-----------------------------E----XXXXXXXX--XXX---------------------------X
XXXXXXXX---XXXXXXXXXXXXXXXXXXXXXXXXXXXXXXXXXXXXXXXXXXXXXXXXXXXXXXXXXXXXXXXXXXXXXXXXXXXXXXXXXXXXXXXXXXXXXXXXXXXXXXXXXXX---XX----XXXXXXXXXXXXX---------------------------X
