------------------------------------------------------------------------------------------------------------------------------------------------------------------------
------------------------------------------------------------------------------------------------------------------------------------------------------------------------
-----------------------------------XXX----------------------------------------------------------------------------------------------------------------------------------
-----------------------------------XXX-----------------------------------------------------XX---------------------------------------------------------------------------
----------------------------------XXXX-----------------------------------------------------XX---------------------------------------------------------------------------
-SSSSSSSSD------------------------XXXXXXX---SSS---------SS---SSS---------------------SS--SSSSDX-----------------SSS-SSSSSS----------------------------------------------
------------------------------------------------------------------------------------------------------------------------------------------------------------------------
--E---------------------------------------------------------------------------------------------------------------------------------------------------------------------
------------------------------------------------------------------------------------------------------------------------------------------------------------------------
-?S--S---SD--------XXX--------------------------------X--------------------S----------D----------------X-X------------------------------X-------------------------XXXX--
-------------------XX---XX----------------------------XX--------------->-----------------------------XXXXX---XX------------------------XX-----------------------X-XXXX--
---------------<>-XX----XX-------------------[]--X----XX--------------<>----------------------------XXXXXX---XX----------------[-------XXX------------------->XXXXXXXXX-
--------E-E----[]XXX---XXX---------------E-E-[]-X----XXX---------EE---[]--E------------------------XXXXXX-X-XXXX---------------[]------XXX-------------E----[]XXXXXXXXXS
XXXXXXXXXXXXXXXXXXXXXXXXXXXX------------XX-X-X-------XXXXXXXXXXXXXXXXXXXXXXXXXXXXXXXXXX-XXX--------XXXXXXXXXXXXXXXXXXXXXXXXXXXXXXXXXXXXXXXXXXXXXXXXXXXXXXXXXXXXXXXXXXXXX
