------------------------------------------------------------------------------------------------------------------------------------------------------------------------
------------------------------------------------------------------------------------------------------------------------------------------------------------------------
-----------------------------------XX-----------------------------------------------------------------------------------------------------------------------------------
-----------------------------------XXX----------------------------------------------------------------------------------X-----------------------------------------------
-----------------------------------XXX----------------------------------------------------------------------------------X-----------------------------------------------
-SSSSSSSSD-------------------SSSSSXXXXXX----SSS------------SSSD--------------------------SS----------------------------SS-----------------------------------------------
------------------------------------------------------------------------------------------------------------------------------------------------------------------------
------------------------------E-----------------------------------------------------------------------------------------------------------------------------------------
------------------------------------------------------------------------------------------------------------------------------------------------------------------------
--------------------XXX--XXX-DS------------------------------DS-D------<>---X---XX----------------<>--------X--------------------------------DS--------------XXX--XXXX-X
-------------------XXXX--XXX-------------------------------------------[]-------XX-----------------]-------XX--------------------XX--------------------------XX--XXX-XXX
---------------<>-XXXXX-XXXX-------------------------------------------[]-------XX----------------[]------XXX--------------------XX--------------------------X]-XXXXXXXX
---------------[XXXXXXX-XXXX------E-E----------------E--[E-E-E-----E---[]------XXXX----------EE---[]-------XX--------------------XXX-------------------------[XXXXXXXXXX
XXXXXXXXXXXXXXXXXXXXXXXXXXXXXXXXXXXXXXXXXXXXXXXXXXXXXXXXXXXXXXXXXXXXXXXXXXXXXXXXXXXXXXXXXXXXXXXXXXXXXXXXXXXXXXXX--------------------X---XXXXXXX---XX----XXXXXXXXXXXXXXXX
