------------------------------------------------------------------------------------------------------------------------------------------------------------------------
------------------------------------------------------------------------------------------------------------------------------------------------------------------------
------------------------------------------------------------------------------------------------------------------------------------------------------------------------
------------------------------------------------------------------------------------------------------------------------------------------------------------------------
------------------------------------------------------------------------------------------------------------------------------------------------------------------------
----S---------------------------------------------------SS---SSS------------------------------------------SSSS-S-----------------------------------------------------SSD
------------------------------------------------------------------------------------------------------------------------------------------------------------------------
------------------------------------------------------------------------------------------------------------------------------------------------------------------------
------------------------------------------------------------------------------------------------------------------------------------------------------------------------
-DS------SD-D------XXXXXXXXX------------------XX--X------------------------XX-X---------SSSDS--D--DS---S-----------------------------S--------------------SS----SSSS---S
------------------XXXXX--XXX-----------------XXX--X-----------------------XXX-------------------------------------------------------------------------------------------
----------------XXXXXXXXXXXX-----------------XX---X---X----------------<-XXX---X---------------------------XX-----------------------------------------------------------
------E-E------XXXXXXXXXXXXX---------------E-XXX--X----X---------------XXXXX--XXXX---E---------------------XX------------E--E------------------------E----------------E-
XXXX--XXX--XXXXXXXXXXXXXXXXXXXX--------------XXXX---XXXXXXXXXX---XX----XXXXXX-XXXXXXXXXXXXXXXXXXXXXXXXXXXXXXXXXXXXXXXXXXXXXXXXXXXXXXXXXXXXXXXXXXXXXX-XXXXXXXXXXXXXXXXXXX
