------------------------------------------------------------------------------------------------------------------------------------------------------------------------
------------------------------------------------------------------------------------------------------------------------------------------------------------------------
------------------------------------------------------------------------------------------------------------------------------------------------------------------------
------------------------------------------------------------------------------------------------------------------------------------------------------------------------
------------------------------------------------------------------------------------------------------------------------------------------------------------------------
S----------------------------------------------------------SSSD------------------------SS-----------------------------------------------------------------------?SD-----
------------------------------------------------------------------------------------------------------------------------------------------------------------------------
----------------------------------------------------------E-------------------------------------------------------------------------------------------------------------
------------------------------------------------------------------------------------------------------------------------------------------------------------------------
-------------------X--X---XX-----D--D--------------------DS------S-------<>--------------D--D------<>-----S--------------------------------------D--D-----SSS---S--?S---
-----------------XXX--X---XX------------------------X--------------------[]------------------------[]--------------------------------------------------------------X----
-----------------XXX--X---XX---------------<>------XX--------------------[]-------------------------]---------------------------<--------<>-<>---------------------XX---
-----------------XXX--X---XX[E-E-E---------[]-E---XXXXXX----------E-E----[]------EE--E------EE-E----]---------------------------]--------[]X[]-E-E------E----------EX---
----------------------------XXXXXXXXXXXXXXXXXXXXXXXXXXXXXXXXXXXXXXXXXXXXXXXXXXXXXXXXXXXXXXXXXXXXXXXXXXXXXXXXXXXXXXXXXXXXXXXXXXXXXXXXXXXXXXXXXXXXXXXXXXXXXXXXXXXXXXXXXXXX
