------------------------------------------------------------------------------------------------------------------------------------------------------------------------
------------------------------------------------------------------------------------------------------------------------------------------------------------------------
------------------------------------------------------------------------------------------------------------------------------------------------------------------------
------------------------------------------------------------------------------------------------------------------------------------------------------------------------
------------------------------------------------------------------------------------------------------------------------------------------------------------------------
-SSSSSDS-------------------------------------------------------S---------------------------------------D?-----S---------------------------------------------------------
------------------------------------------------------------------------------------------------------------------------------------------------------------------------
------------------------------------------------------------------------------------------------------------------------------------------------------------------------
------------------------------------------------------------------------------------------------------------------------------------------------------------------------
-----D---------<>-------XX---------------------XXXX--X--------------D-----------------------------SS----S-S----S----------------------X---XX-DS-----------S--<>-----S---
---------------[]-------XX--------------------XXX-X-XX--------------------------------------------------------------------------------X---XX-----------------[]---------
---------------[]------XXXX-----------------XXXXXXXXXXX----------------<>XX------<>----------------------------------------------X---XX---XX-----------------[]---------
[E-E-E----E-E--[]---XX-XXXXX---------------XXXXXX-XXXXX-----------E----[]XX------[]----------E-E-E-E-----------------------------XXXX-X--XXX------E-E--E-E-E-[]-EE-EEE-E
XXXXXXXXXXXXXXXXXXXXXXXXXXXXXXXX---XXXXXXXXXXXXXXXXXXXXXXXXX----XXXXXXXXXXXXXXXXXXXXXXXXXXXXXXXXXXXXXXXXXXXXXXXXXXXXXXXXX---XXXXXXXXXX---XXXXXXXXXXXX--XXXXXXXXXXXXXXXXX
