------------------------------------------------------------------------------------------------------------------------------------------------------------------------
------------------------------------------------------------------------------------------------------------------------------------------------------------------------
-------XX---------------------------------------------------------------------------------------------------------------------------------------------------------------
-------XXX--------------------------------------------------------------------------------------------------------------------------------------------------------------
-------XXX--------------------------------------------------------------------------------------------------------------------------------------------------------------
-------XXXXX----SSSS----------------------------------S----SSSDSSD------------SSS---------------------------------------------------------------------------------------
------------------------------------------------------------------------------------------------------------------------------------------------------------------------
------------------------------------------------------------------------------------------------------------------------------------------------------------------------
------------------------------------------------------------------------------------------------------------------------------------------------------------------------
--------------------------------SSSDS--D--DS---SSS--------S--S--D--D------------X----------------------------------------S?-D------XXXXXXX-------DS-D-----<>------S-----
----------------------------------------------------------------------------X---X-------------------------------------------------XXXXX-XX-X->------------[]------------
-----------------------------------------------------------------------<>--XX--XXX----------------------------------------------XXXXXXXXXXXX<]------------[]------------
---------------E---------EXX------------------------------------E------[]-XXX-XXXX-----------------------------E----------E----XXXXXXXXXXXXX[]-E-E----E-E-[]--E---------
XXX---XXX---XXXXXXXXXXX-XXXXXXXXXXXXXXXXXXXXXXXXXXXXXXXXXXXXXXXXXXXXXXXXXXXXXXXXXXXXXXXXX---------------------XXXXX----XX------XXXXXXXXXXXXXXXXXXXXXXXXXXXXXXXXXXXXXXXXX
