------------------------------------------------------------------------------------------------------------------------------------------------------------------------
------------------------------------------------------------------------------------------------------------------------------------------------------------------------
------------------------------------------------------------------------------------------------------------------------------------------------------------------------
------------------------------------------------------------------------------------------------------------------------------------------------------------------------
------------------------------------------------------------------------------------------------------------------------------------------------------------------------
--SSSSS-------------------------SSS-------------------------SD-----------------------S-SSSSS----------------------------XX-----------SSSSS-S----------------------------
------------------------------------------------------------------------------------------------------------------------------------------------------------------------
--E---------------------------------------------------------------------------------------------------------------------------------------------------------------------
------------------------------------------------------------------------------------------------------------------------------------------------------------------------
-?S------S?-D--------XX-X-------SSSDS--D-----------------DS------S------------XXX-----D------------------XX----X--------------------------------SSSDS-----<>---SD-------
-------------------XX---XX----------------------------------------------------XXX----------------------XXXX--XXX------------------------------------------[]------------
---------------[>-XXXX-XXXX----------------<>-------------------------------X-XXX------------------<>-XXXXXXXXXX--------------<---------------------------[]------------
----------E-E--[]-XXXXXXXXX--E-------------[]-----------------------------XXXXXXXX-X---------------[]XXXXXXXXXXX--------------[]-----------E-E------------[]--E---------
XXXXXXXXXXXXXXXXXXXXXXXXXXXXXXXXXXXXXXXXXXXXXXXXXXXXXXXXXXXXXXXXXXXXXXXXXXXXXXXXXXXXXXXXXXXXXXXXXXXXXXXXXXXXXXXXXXXXXXXXXXXXXXXXXXXXXXXXXXXXXXXXXXXXXXXXXXXXXXXXXXXXXXXX
