------------------------------------------------------------------------------------------------------------------------------------------------------------------------
------------------------------------------------------------------------------------------------------------------------------------------------------------------------
------------------------------------------------------------------------------------------------------------------------------------------------------------------------
------------------------------------------------------------------------------------------------------------------------------------------------------------------------
------------------------------------------------------------------------------------------------------------------------------------------------------------------------
-----------------------------------------------------------?S---------------------S----------------------------------------------------------SSSSSSSSD------------------
------------------------------------------------------------------------------------------------------------------------------------------------------------------------
------------------------------------------------------------------------------------------------------------------------------------------------------------------------
------------------------------------------------------------------------------------------------------------------------------------------------------------------------
--------------DS-----S-------DS-------------->>---S-------S--D--D-----<>>---S-SSS--S---------S---------X--XXX----------------------X-XX--X-----------S--D------XXXX-----
--------------------------------------------[]>-----------------------[]------------------------------XXX-XXX--------------------XXX-XXXXXXX------------------XXX-----X-
--------------------------------------------[[]---------<]------------[]-----------------------------XXXX-XXX-------------------XXXX--XXXXXX---------------<XXXXX----XX-
--------------------------E------------EE---[[--E-------[]-E-E------E-[]----------------------E----XXXXXXXXXXX------------------XXXXXXXXXXXX----------E----XXXXXX-X-XXX-
XXXXXXXXXXXXXXXXXXXXXXXXXXXXXXXXXXXXXX-XXXXXXXXXXXXXXXXXXXXXXXXXXXXXXXXXXXXXXXXXXXXXXXXX-XXXXXXXXXXXXXXXXXXXXXXXXXXXXXXXXXXXXXXXXXXXXXXXXXXXXXXXXXXXXXXXXXXXXXXXXXXXXXXX
