------------------------------------------------------------------------------------------------------------------------------------------------------------------------
------------------------------------------------------------------------------------------------------------------------------------------------------------------------
------------------------------------------------------------------------------------------------------------------------------------------------------------------------
------------------------------------------------------------------------------------------------------------------------------------------------------------------------
------------------------------------------------------------------------------------------------------------------------------------------------------------------------
---SSSDS-D------------------------------------------SSSS------------------------------------------------------SD--------------D--SS------------?SSS---------------------
------------------------------------------------------------------------------------------------------------------------------------------------------------------------
------------------------------------------------------------------------------------------------------------------------------------------------------------------------
------------------------------------------------------------------------------------------------------------------------------------------------------------------------
-?S------------------D---------------------------S--------------------S---------------------------S-----SSSS--?S-----SSDS------<>----X-XXX------------------>----SS-----
----------------<--------------------------------------------------------------------------------------------------------------[]---X--XXX-----------------[]-----------
----------------<]-------<>-------------------------------------------------------------------------------------<>-------------[]--XXXXXXX-----------------[]-----------
----------------[]-------[]-----------------------------------------E------------E-----------EE-E----[]-------E-[]-E-E---------[]--XXXXXXX------------E-E--[]-E-------E-
XXXXXXXXXXXXXXXXXXXXXXXXXXXX---------------XX-------XXXXXXXXXXXXXXXXXXXXXXXXXXXXXXXXXXXXXXXXXXXXXXXXXXXXXXXXXXXXXXXXXXXXXXXXXXXXXXXXXXXXXXXXXXXXXXXXXXXXXXXXXXXXXXXXXXXX
