------------------------------------------------------------------------------------------------------------------------------------------------------------------------
------------------------------------------------------------------------------------------------------------------------------------------------------------------------
------------------------------------------------------------------------------------------------------------------------------------------------------------------------
------------------------------------------------------------------------------------------------------------------------------------------------------------------------
------------------------------------------------------------------------------------------------------------------------------------------------------------------------
----S------------------------------------------------------SSD------------------------------------------------------------------------------S-----------------------SSSS
------------------------------------------------------------------------------------------------------------------------------------------------------------------------
------------------------------------------------------------------------------------------------------------------------------------------------------------------------
------------------------------------------------------------------------------------------------------------------------------------------------------------------------
--D-------------<>>-------------------------------X---XX--S-------------<>----SXS-----------------D------S----------SSSDS-----<>---SSS----------SSS-------<>---SSS-----S
----------------[]-------------------------------XX---XX----------------[]-----X----------------------------------------------[]--------------------------[]------------
----------------[]---------------------------X>-XXX--XXX----------------[]----XX----------------------------------------------[]--------------------------[]------------
-----------EE---[]--E----EEE-----------------[XXXXX--XXX---------EEEE---[]-----XX--E--------------------------EE--------------[]----------E----------E----[]----------E-
XXXXXXXXXXXXXXXXXXXXXXXXXXXXXXXXXXXXXXXXXXXXXXXXXXXXXXXXXXXXXXXXXXXXXXXXXXXXXXXXXXXXXXXXXXXXXXXXXXXXXXXXXXXXXXXXXXXXXXXXXXXXXXXXXXXXXXXXXXXXXXXXXXX-XXXXXXXXXXXXXXXXXXXX
