------------------------------------------------------------------------------------------------------------------------------------------------------------------------
------------------------------------------------------------------------------------------------------------------------------------------------------------------------
-------------------------------------------------------------------------------------------XX---------------------------------------------------------------------------
-------------------------------------------------------------------------------------------XXX--------------------------------------------------------------------------
-------------------------------------------------------------------------------------------XXX--------------------------------------------------------------------------
-------------------------------?S-------------------------------S--------------------------XXXXXX---S?S-------------S-------------------------------------------?SSS-SSS
------------------------------------------------------------------------------------------------------------------------------------------------------------------------
------------------------------------------------------------------------------------------------------------------------------------------------------------------------
-------------------------------------------------------------------------------------------------------------------------------------------X----------------------------
-----------D--D----S-S-----------D--DSD--------X-X--X-----------------------XXX--XXX-----------------<>----------DS------S?-D--------XX-XXXX----SSS-------->----S------S
--------------------------------------------<--XX--XXX--------------------XXXXX--XXX-----------------[]--------------------------X--XXX--XXX---------------]------------
----------------------------X>--------------<>XXX--XXX------------------XXXXXXX--XXX-----------------[]-------------------------XXXXXXX--XXX--------------[]------------
----------------------------[]---E----------[]XXXXXXXX-----------------XXXXXXXX-XXXX-------------E-E-[]-E-------------------E---XXXXXXX--XXX-E-------EE-E-[]--------E---
XXXXXXX--XXXXXXXXXXXXXXXXXXXXXXXXXXXXXXXXXXXXXXXXXXXXXXXXXXX-----------XXXXXXXXXXXXXXXX---XX----XXXXXXXXXXXXXXXXXXXX--XXXX-XXXXXXXXXXXXXXXXXXXXXXXXXXXXXXXXXXXXXXXXXXXXX
