------------------------------------------------------------------------------------------------------------------------------------------------------------------------
------------------------------------------------------------------------------------------------------------------------------------------------------------------------
--------X--------------------------XX-----------------------------------------------------------------------------------------------------------------------------------
------XXXX-------------------------XXX----------------------------------------------------------------------------------------------------------------------------------
-------XXX-------------------------XXX----------------------------------------------------------------------------------------------------------------------------------
------XXXXXX----------------------XXXXXX-----------------SSSSSSS-D-------------------SSSSSSS-D----------------------------------------S-SSSS-SSS-SSS--------------SSSS-S
------------------------------------------------------------------------------------------------------------------------------------------------------------------------
------------------------------------------------------------------------------------------------------------------------------------------------------------------------
------------------------------------------------------------------------------------------------------------------------------------------------------------------------
---------------------S------------------------------------S------S?-D--------X--XX---DS------S?-D------X--XX------------------S------S-----S--D-------------------------
----------------------------------------------------------------------------XX--XX--------------------XXX-XXX-----------------------------------------------------------
------------------------------------------------------------------------<>-XXX--XXXX---------------<>XXX--XXX-----------------------------------------------------------
--------------------------E---------------------------------------E-E---[]-XXX--XXXX----------E----XXXXX--XXX------------------E----------E-----------------------------
XXXXXXXXXXXXXXXXXXXXXXXXXXXX------------X--XXXXXX---XXXXXXXXXXXXXXXXXXXXXXXXXXXXXXXXXXXXXXXXXXXXXXXXXXXXXXXXXXXXXXXXXXXXXXXXXXXXXXXXXXXXXXXXXXXXXXX--XXXXXXXXXXXXXXXXXXX
