------------------------------------------------------------------------------------------------------------------------------------------------------------------------
------------------------------------------------------------------------------------------------------------------------------------------------------------------------
------------------------------------------------------------------------------------------------------------------------------------------------------------------------
------------------------------------------------------------------------------------------------------------------------------------------------------------------------
------------------------------------------------------------------------------------------------------------------------------------------------------------------------
---------------------------------------------------------------------------------------SSSD--D-------------------------------------------------SSSD--D------------------
------------------------------------------------------------------------------------------------------------------------------------------------------------------------
--------------------------------------------------------------------------------------E-------------------------------------------------------E-------------------------
------------------------------------------------------------------------------------------------------------------------------------------------------------------------
----SSSDS--D--D----SDS----------SSSDS--D--DS>---SSS--------------------------XX---XX-?S------S?-------------X------------------------SS------?S-----DSD-----<>---X--XX--
-------------------------------------------[]----------------------------XX--XX---XX--------------------X---XX-------------------[]-------------------------[]---XXXXX--
---------------]---------------------------[]----------------------------XXXXXX---XX---------------->--XXX--XXX------------------<>-------------------------[]-XXXXXXXXX
-X-E-----------]-------------E-E------------]--------------------------XXXXXXXX--XXX----------E-E---XXXXXXX-XXX------------------[]-------E-------E-E--E----[]--XXXXXXXX
XXXXXXXXXXXXXXXXXXXXXXXXXXXXXXXXXXXXXXXXXXXXXXXXXXXXXXXXXXXX---X---------XXXXX---XXXXXXXXXXXXXXXXXXXXXXXXXXXXXXXXXXXXXXXXXXXXXXXXXXXXXXXXXXXXXXXXXXXXXXXXXXXXXXXXXXXXXXX
