------------------------------------------------------------------------------------------------------------------------------------------------------------------------
------------------------------------------------------------------------------------------------------------------------------------------------------------------------
------------------------------------------------------------------------------------------------------------------------------------------------------------------------
------------------------------------------------------------------------------------------------------------------------------------------------------------------------
------------------------------------------------------------------------------------------------------------------------------------------------------------------------
---?S------------------------SSSSSDSSDS-----------SSSSSS-----------------------------------------------S?S-------------------------------------S-SDS--------------------
------------------------------------------------------------------------------------------------------------------------------------------------------------------------
------------------------------E-----------------------------------------------------------------------------------------------------------------------------------------
------------------------------------------------------------------------------------------------------------------------------------------------------------------------
--S--D---------<>-----S------?S------S-------------------------------------S-------------S--D-----SS----S-SS---S-----D--D-------<>-----XX-----S--S--D--D------------X---
---------------[]------------------------------------------------------>--------------------------------------------------------[]-----XX--------------------------XXX--
---------------[]--------------------------<>-------------------------<>--------------------------------------------------------[]----XXXX------------------<>-----XXX--
---------EE-E--[]--------E-E--------E-E----[]-------EE------------E---[]--E----------E-E-E-----E----------------[]-E-E-----EE---[]--XX-XXX-S--------E--E----[]---X-XXX--
XXXXXXXXXXXXXXXXXXXXXXXXXXXXXXXXXXXXXXXXXXXXXXXXXXXXXXXXXXXXXXXXXXXXXXXXXXXXXXXXXXXXXXXXXXXXXXXXXXXXXXXXXXXXXXXXXXXXXXXXXXXXXXXXXXXXXXXXXXXXXXXXXXXXXXXXXXXXXXXXXXXXXXXX
