------------------------------------------------------------------------------------------------------------------------------------------------------------------------
------------------------------------------------------------------------------------------------------------------------------------------------------------------------
--------------------------------------------------------------------------------------------X---------------------------------------------------------------------------
-------------------------------------------------------------------------------------------XXX--------------------------------------------------------------------------
-------------------------------------------------------------------------------------------XXX--------------------------------------------------------------------------
------------------------------------------------------------------------------------S------XX---------------S--------------------------------------------------D--------
------------------------------------------------------------------------------------------------------------------------------------------------------------------------
------------------------------------------------------------------------------------------------------------------------------------------------------------------------
------------------------------------------------------------------------------------------------------------------------------------------------------------------------
--------------S------SS----S-?S-----D-D-----<X---X--XX-X----------------------X----------------D--D------------------------------<>---S---X?----SSSDS-----<S----SSSS----
--------------------------------------------[]>--XX-XXXX-------------------X--XXXX-----------------------------------------------[]-------XX--------------[]------------
--------------------------------------------[]--XX--XXXX----------------<XXXX-XXXXX----------------------------------------------[]-------XX---------------]------------
---------E--E-------------E-------E-E--E----[]-XXXX-XXXX-X------E-------XXXXXXXXXXXX-----------------------------------------E-E-[]-E-----XX-E-E-E------E-------------E-
XXXXXXXXXXXXXXXXXXXXXXXXXXXXXXXXXXXXX--XXXXXXXXXXXXXXXXXXXXXXXXXXXXXXXXXXXXXXXXXXXXX---XXX-------------------XXXXXX----XX---XXXXXXX-------XXXXXXXXXXXXXXXXXXXXXXXXXXXXXX
