------------------------------------------------------------------------------------------------------------------------------------------------------------------------
------------------------------------------------------------------------------------------------------------------------------------------------------------------------
---------------------------------------------------------------XX-------------------------------------------------------------------------------------------------------
--------------------------------------------------------------XXXX-----------------------------------------------------XX-----------------------------------------------
--------------------------------------------------------------XXXX-----------------------------------------------------XX-----------------------------------------------
-SSSSSSS--------------------SS---SSSS-------------------------XXXXXX-----------------SSSSSSS--------------SSSSSS---SSSD-XDX---------------------SSS---------------------
------------------------------------------------------------------------------------------------------------------------------------------------------------------------
------------------------------------------------------------------------------------------------------------------E-----------------------------------------------------
------------------------------------------------------------------------------------------------------------------------------------------------------------------------
---------S?-D-------XXX-XXXX-------------------------------------------------S----------SD--------->---SD--------DS------S-------<>---X----------D-------------X---XX---
------------------XXXXX--XXX---------------------------------------------------------------------->>-----------------------------[]------------------------>---XX--XXX--
----------------XXXXXXXXXXXX--------------<>------------------------------------------------------[]-----------------------------[]-------XX--------------<>--XXXXXXXX--
----------E----XXXXXXXX-XXXX--------------[]--------------------------------------E-----------E---[]--E---------------E-E----E---[]-E-----XX----------E---[]--XXXXXXXX--
XXXXXXXXXXXXXXXXXXXXXXXXXXXXXXXXXX---XXXXXXXXXXXXXXXXXXXXXXXXXXXXXXXXXXXXXXXXXXXXXXXXXXXXXXXXXXXXXXXXXXXXXXXXXXXXXX---XXX---XXXXXXXXXXXXXXXXXXXXXXXXXXXXXXXXXXXXXXXXXXXX
