------------------------------------------------------------------------------------------------------------------------------------------------------------------------
------------------------------------------------------------------------------------------------------------------------------------------------------------------------
------------------------------------------------------------------------------------------------------------------------------------------------------------------------
------------------------------------------------------------------------------------------------------------------------------------------------------------------------
------------------------------------------------------------------------------------------------------------------------------------------------------------------------
------------------------SSSS-------------------S?SDSSSSS---SS?D------------------------SS?---------------------------------------------------S---DS---------------------
------------------------------------------------------------------------------------------------------------------------------------------------------------------------
---------------------E------------------------------------E-------------------------------------------------------------------------------------------------------------
---------------------------------------------------------------------------------------------------------------X--------------------------------------------------------
----SSS-------<>---S?S-----S----SSSDS-----SS----S------S-?S--D--DSD-----<------XX------------S--D----X---XX-XXXX--------------S-------S---------------------------------
--------------[]---------------------------]-----------------------------]-----XX-------------------<X--XXX--XXX--------------------------------------------------------
--------------[]--------------------------[]----------------------------[]----XXX-------------------[X-XXX--XXXX-----------------<--------------------------<>X------X--
--------------[]----------E---------------[]--------E-E--E---E--E--E-----]---X-XX-------------E-E---[]-XXXX-XXXX------------EE---[]------E-E---------EE-----[XXX----XX--
XXXXXXXXXXXXXXXXXXXXXXXXXXXXXXXXXXXXXXXXXXXXXXXXXXXXXXXXXXXXXXXXXXXXXXXXXXXXXXXXXXXXXXXXXXXXXXXXXXXXXXXXXXXXXXXXXXXXXXXXXXXXXXXXXXXXXXXXXXXXXXXXXXXXXXXXXXXXXXXXXXXXXXXX
