------------------------------------------------------------------------------------------------------------------------------------------------------------------------
------------------------------------------------------------------------------------------------------------------------------------------------------------------------
-------------------------------------------------------------------------------------------XX-------------------------------------------------------X-------------------
-------------------------------------------------------------------------------------------XXX--------------------------XX-------------------------XXX------------------
-------------------------------------------------------------------------------------------XXX---------------------------X-------------------------XXX------------------
-------------------------------------------------------------------------------------------XXXXX----SSS------------------XX-----SS---SSSSD----------XXX-----------------
------------------------------------------------------------------------------------------------------------------------------------------------------------------------
------------------------------------------------------------------------------------------------------------------------------------------------------------------------
------------------------------------------------------------------------------------------------------------------------------------------------------------------------
-----------------------------------------------------------------------------------------------D--D------S-------D-------S------------XX------------------S--<>---------
----------------------------------------------X-------X-------------------------------------------------------------------------------XX---------------------[]---------
---------------------------------------------XXX-----<XX---------------<>--------<>-----------------------------------------------X---XX---------------------[]---------
---------------]-----------------------------XXXX----[]X---------------[]--------[]--------------------------------------------E--XX--XX---E-------------E-E-[]-E------E
XXXXX-----XXXXXXXXXXXXXXXXXXXXXXXX---XXX---XXXXXXXXXXXXXXXXXXXXXXXXXXXXXXXXXXXXXXXXXXXXXXXXX--XXXXXXXXXXXXXXXXXXXX-----XX----X---X--X-XXXXXXXXX---XXX--XXXXXXXXXXXXXXXXX
