------------------------------------------------------------------------------------------------------------------------------------------------------------------------
------------------------------------------------------------------------------------------------------------------------------------------------------------------------
------------------------------------------------------------------------------------------------------------------------------------------------------------------------
------------------------------------------------------------------------------------------------------------------------------------------------------------------------
------------------------------------------------------------------------------------------------------------------------------------------------------------------------
-------------------------------------------------------------------------------------------------------------------SS---------------------------------------------------
------------------------------------------------------------------------------------------------------------------------------------------------------------------------
------------------------------------------------------------------------------------------------------------------------------------------------------------------------
------------------------------------------------------------------------------------------------------------------------------------------------------------------------
----------------------XXXX-X----DS--------->---SDS--------------------------XXX-XXXX----------------------S------?S------S?-----------X-----------------D------X-XXXXX-X
--------------------XXXXXX-X--------------[>-------------------------------XXXX-XXXX---------------------------------------------XXX--------------------------XXXXXXXXXX
------------------XXXXXXXXXX--------------[]---------------------------->-XXXXXXXXXX---------------<>---------------------------XXXX-----X------------------XXXXXXXXXXXX
------------------XXXXXXXXXX--------------[]--E-------------------------XXXXXXXXXXXX---------EE----[]-E-------------------E-E---XXXX-----XX-----------E-----XXXXXXXXXXXX
XXXX---XX----X--XXXXXXXXXXXXXXXXXXXXXXXXXXXXXXXXXXXXXXXXXXXXXXXXXXXXXXXXXXXXXXXXXXXXXXXXXXXXXXXXXXXXXXXXXXXXXXXXXXXXXXXXXXXXXXXXXXXXXXXXXXXXXXXXXXXXXXXXXXXXXXXXXXXXXXXX
