------------------------------------------------------------------------------------------------------------------------------------------------------------------------
------------------------------------------------------------------------------------------------------------------------------------------------------------------------
------------------------------------------------------------------------------------------------------------------------------------------------------------------------
------------------------------------------------------------------------------------------------------------------------------------------------------------------------
------------------------------------------------------------------------------------------------------------------------------------------------------------------------
SSS--SSSSD------------SSSSSSSS-----------------------------SSSD----------------S--------------------------SSSSSS---------------------------------SSS--------------------
------------------------------------------------------------------------------------------------------------------------------------------------------------------------
---------------------------------------------------------------------------------------------------------E--------------------------------------------------------------
------------------------------------------------------------------------------------------------------------------------------------------------------------------------
----S---------D------S-----------------D--D--------------DS------S--------XX----X--------------D--DS---S?S----------SS--S--D-------S-D----------------------------------
--------------------------------------------------------------------------XX---XX-----------------------------------------------<---------------------------<-----------
---------------------------------------------<>--------------------------XXXX-XXX-----------------------------------------------<--------<>-----------------<>-------<>-
---------------------------------------------[]--------X--------E-E----XXXXXXXXXXX----------------------------E----------------[[--------[]----------E-E----[]-------[]-
XXXXXXXXXXXXXXXXXXXXXXXXXXXXXXXXXXX--XXXXXXXXXXXXXXXXXXXXXXXXXXXXXXXXXXXXXXXXXXXXXXXXXXXXXXXXXXXXXXXXXXXXXXXXXXXXXXXXXXXXXXXXXXXXXXXXXXXXXXXXXXXXXXXXXXXXXXXXXXXXXXXXXXX
