------------------------------------------------------------------------------------------------------------------------------------------------------------------------
------------------------------------------------------------------------------------------------------------------------------------------------------------------------
------------------------------------------------------------------------------------------------------------------------------------------------------------------------
-------------------------------------------------------------------------------------------------------------------------X---------------------------X------------------
------------------------------------------------------------------------------------------------------------------------------------------------------------------------
----S----------------------------------------SS------------SSSSS---------------------------------------------------------X---------D--------S---------------------------
------------------------------------------------------------------------------------------------------------------------------------------------------------------------
------------------------------------------------------------------------------------------------------------------------------------------------------------------------
------------------------------------------------------------------------------------------------------------------------------------------------------------------------
-DS------S------------S-------------D-----S--<>----XX-------------------------------------------------------------------------SS------S----------------------XXX--X---XX
---------------------------------------------[]----XX--------------------------------------------------------------------------------------------------------XX---X---XX
-----------------<>--------------------------[]---XXX---------------------------------------------->-----------------------------<>--------------------------XX---X---XX
-----------------[]--------------------E-E---[]-EX-XXX-E----------------]--------------------------]---------------------E-E-E-E-[]--------E-----------------XXX--X---XX
XXX---XXX---XXXXXXXXXX-XXXXXXXXXXXXXX--XXXXXXXXXXXXXXXXXXXXXXXXXXXXXXXXXXXXXXXXXXXXXXXXX--XXXX-XXXXXXXXXXXXXXXXXXXXXXXXXXXXXXXXXXXXXXXXXXXXX-------------------------XXX
