------------------------------------------------------------------------------------------------------------------------------------------------------------------------
------------------------------------------------------------------------------------------------------------------------------------------------------------------------
------------------------------------------------------------------------------------------------------------------------X-----------------------------------------------
-----------------------------------------------------------------------------------------------------------------------XX-----------------------------------------------
-----------------------------------------------------------------------------------------------------------------------XX-----------------------------------------------
----------------------SSSSSS----------------------------------------------------------SDSSD----------------------S-SSSDSSDSX--------------------------------------------
------------------------------------------------------------------------------------------------------------------------------------------------------------------------
---------------------E--------------------------------------------------------------------------------------------E-----------------------------------------------------
------------------------------------------------------------------------------------------------------------------------------------------------------------------------
--------------DS---S?S---------------------------X----XX----------------------X---------SSSDS------<>---SDS------DS--------------XXX------------XDS-D-------------------
---------------------------------------------X---X----X------------------XX-------X----------------[]----------------------------XX---X-XX------------------------------
--------------------------------------------XXXXXX---[XX-----------------XX-------XX---------------[]----------------------------XXX--XXXXX-<>--------------------------
--------------------------------------------XXXXX----[]X-----------------XXX------XX-E-E-E-----E---[]-----------------E---------XXXXXXXXXX--[]-E-E------E---------------
XXXXXX---XXXXXXXXXXXXXXXXXXXXXXXXXXXXXXXXXXXXXXXXXXXXXXXXXXX------------XXXXX--XXXXXXXXXXXXXXXXXXXXXXXXXXXXXXXXXXXXXXXXXX---XXXXXXXXXXXXXXXXXXXXXXXXXXXXXXXXXXXXXXXXXXXX
