------------------------------------------------------------------------------------------------------------------------------------------------------
xxxxxxxxxxxxxxxxxxxxxxxxxxxx-------------------------------------------------------------------------------x-xxxxxxxxxxxxxxxxxxxxxx-------------------
SSSSSSSSSSSSSSSSSSSSSSSSSSS-x---SSSSSSSSSSSSSSSS--------SSSSSSSSSSSS?SSSSSSSSSSSSSSSSSSSSSSSSSSSSSSSSSSSSSSSSSSSSSSSSSSSSSSSSSSSSSS-------------------
SS---------------------------x--SSSS--------------------SSSS---------SSSSSSSSSSSSSSSS--SSSSSSS-------SSSSSSSSSSSSSSS----------------------------------
SS----------------------------x-SSSS--------------------SSSS---------SSSSSSSSSSSSSSSS--SSSSSSS-------SSSSSSSSSSSSSSS----------------------------------
SS---E---------E---------------xSSSS-------------xx--xxxSSSS---------SSSSSSSSSSSSSSSS--SSSSSSS-------SSSSSSSSSSSSSSS----E-----------------------------
----<>--------->----------------x---------------xx-xxx--x--------xxxxx------------------------------oSSSS--------------<>----------------------------x
----[]--------->-----------------x-------------xx---x----x------xx----x------------]xxx------xxx--xxxSSSS--------------[]------------------------xxxxx
----[]--------<>-----------------oxxx------xxxxx---<>----oxxx--xx------x----xxxxxxxxx--xxxxxxx--xxx--SSSS---------<----[]-----------------------xxXSSS
E--?[]S-------[]----------------S?SS-x----xx-XXX---[]---S?SS-xxx--------x--xx-<>SSSSS--SSSSSSS--Q<>--SSSS<---E---<>---?SSS--E------------------xxXX---
>---[]--------[]--<>------E-----SSS---x--xx--------[]---SS----<>---------xxxX-[]SSSSS------------[]---------<>---[]--------<>----SS------E----xxXXX--<
]---[]----<>--[]--[]-----<>-----SS-----xxx---------[]---SS----[]---------EEXX-[]SSSSS------------[]---------[]---[]--------[]----SS-----<>---xxXXXX--[
]---[]----[]--[]--[]-----[]-------E-EE--xX---------[]-----E-E-[]----------XXX-[]SSSSS----------X-[]---------[]---[]--------[]----SSxxxxxxxxxxxXXXXX--[
XXXXXXXX--XX--XX--XX---XXXXXXXXXXX-XXXXXXX---------XXXXXXX-XXXXXXXXXX-XXEXXXX-XXXXXXXXXXXXXXXXXXXXXXXXXXXXXXXXXXXXXXXX----XXX----XXXXXXXXXXXXXXXXXXXXX