------------------------------------------------------------------------------------------------------------------------------------------------------
------------------------------------------------------------------------------------------------------------------------------------------------------
------------------------------------------------------------------------------------------------------------------------------------------------------
------------------------------------------------------------------------------------------------------------------------------------------------------
----xx--------------------------------------------------------------------------xxxx------------------------------------------------------------------
---xx-x-----S--------XQQ?QQX---------------------------------------------------xxXX-x----------------------------------------------QQQ?QQQ?QQQQQ------
--xx---x----S--------X-----X--------------------------------------------------xxXXX--x----------------------------------------------------------------
-xx-----x------------X-----X-------------------------------------------------xxXXXX---x---------------------------------------------------------------
xx-------x--SSS------XE-E--X------------------B-----------------------------xxXXXXX----x----------E--------------oo-----------------------------------
x---------x-SSS------XQQ-QQX-----------------xxxxxxxxx----SSQS--------X----xxXXXXXX--S--x-----------xxxx--------o--o---------------Q-SSSSSSSSSSS------
x----------xSSS-------------------[]--------xxXXXXX<>-xXX---------E---X---xxXXXXXXX------x---------xx<>-x---------------------------------------------
-------------SSx-----------E------[]-------xxXXXXX-[]--x--------------X--xxXXXXXXXX-------x-------xx-[]--x--------------------------E---E---Exxx------
-E---------X-SS-xxxxxxxxxxxxxxx---[]-------xXXXXXX-[]---xxxxxxxxxxxxxxxxxxXXXXXXXXX-------Xxxxxxxxx--[]---xxxxxxxxxxxxxxxxxxxxxxxxxxxxxxxxxxxx--xxxxxx
XXXXXXX----XXXXXXXXXXXXXXXXXXXXXXXXXXXXXXXXXXXXXXXSXXXXXXXXXXXXXXXXXXXXXXXXXXXXXXXXXXXXXXXXXXXXXXXXXXXXXXXXXXXXXXXXXXXXXXXXXXXXXXXXXXXXXXXXXXX--XXXXXX