------------------------------------------------------------------------------------------x-----------------------------------------------------------
-------------------------------------------------------------------------------------------x----------------------------------------------------------
--------------------------------------------------------------------------------------------xx--------------------------------------------------------
----------------------------------------------------------------------------------------------x------------E------------------------------------------
----------xxxxx---------------------------------------------------------------------------------------------------------------------------------------
---------xxXXX-x------------------SSSS-----------------------XXXX-------------------------------------XXXXEXXXXX------------XXXXXXXXXXXXXXX-----------
E-------xxXEXX--x----------------------------------------------------------------XX--------------------------------------------[]-------[]------------
-------xxEXXXX--------------------------xxx-------------------------------------XXX-------------------xxxxx--------------------[]-------[]------------
------xxEXXXXX------------------------xxx--x-----------------------------------XXXX---------------xxxxx----xxxxxxxx------------[]-------[]-------xxx--
-----xxXXXXXXX-----------------------xxXX---x-----------------------<>--------XXXXX--------------xxXXXXEXEEXXXXXXX-x-----------[]-------[]------xx<-x-
----xxXXXXXXXX--x--------xxx--------xx-XX----x------xxx-------------[]-------XXXXXX-------------xx------------------x----------<>-------<>-----xx-[]-x
---xxXXXXXXXXX---x------xxB-x------xx--XX-----x----xxB-x------------[]------XXXXXXX------------xxXX------------------xx--------xxx------xxx---xx--[]--
xxxxXXXXXXXXXX----xxxxxxx-b--xxxxxxx--EXX------xxxxx-b--xxxxxxxxxxxx[]-----XXXXXXXX--------xxxxx---------------------B-xxxxxxxxxE-xxxxxxxE-xxxx---[]--
XXXXXXXXXXXXXXXXXXXXXXXXXXXXXXXXXXXXXXXXX------XXXXXXXXXXXXXXXXXXXXXXXXXXXXXXXXXXXX-------XXXXXXXXX--------------XXXXXXXXXXXXXXXX-XXXXXXXX-XXXXX--XXXX