------------------------------------------------------------------------------------------------------------------------------------------------------
------------------------------------------------------------------------------------------------------------------------------------------------------
SSSSSSSSSSSSSSSSSSSSSSSSSSSSSSSSSS-----SSSSSS--SSSSSSSSSSSSSSSSSSSSSS----SSSSSSSSSSSSSSSSSSSSSSSSSSSSSSSSSSSSSSSSS?SSSSSSSSSSSSSSSSSSSSSSSSSSSSSSS----
-----------SSSSSSSSSSSSSS-------[]---------------------------------------------SSSS---S-S--SSSS------SSSS---------------------------------------------
-----------SSSSSSSSSSSSSS-------[]---------------------------------------------SSSS---S-S--SSSS--E---SSSS---------------------------------------------
-----------SSSSSSSSSSSSSS-------[]------xxxxxxxxx-------oooo------SS------S-S---S-----S-S---S----SS----------oooooo--------------------------------xx-
--------------------------------[]------xSSSSSSSS-----------------SS------S-S---S-----S-S---S----SS-----------------------------------------------xx-x
--------------------------------[]------xSSSSS--------S-SSSS-S----SS------S-S---S-----S-S---S----SS----------SSSSSS--------------xxx-------------xx--X
xxxxxxxxxxxxxxxxxxxxxxxxxx------[]---xxxxSSSSS--------SoS--SoS----SS----?-SoS---So??--S-S---So??-SS---E------SSSSSS------------xxx--x--------xxxxx----
SSS????????SSSSSSSSSE??<>-x-----[]--xx--?SSSSS???x----SSS--SSS----SS-x----SSS---SSS---S-S---SSS--SS--SSSS---------------------xx<>---x------xx-XXX----
SSSSSSSSSSS------------[]--x----<>-xx----SSSSSSSS-x-----------------SS------------------------------EE-----------------------xx-[]----xxx--xx---------
SSSSSSSSSSS------------[]---x-----xx-----SSSSSSSS--x----------------SS----------------------------------xxxxx---------------xx--[]----<>-xxx----------
>----------------------[]----xxxxxx--------------E--xxxxxxxxxxxxxxxxxxxxxxxxxxxxxxxxxxxxxxxxxxxxxxxxxxxxx----xxxxxxxxxxxxxxxx---[]--E-[]--x-----------
XX-XXXXXXXXXXXXXXXXXXXXXXXXEXXXXXXX----XXXXXX-XXXXXXXXXXXXXXXXXXXXXXXXXXXXXXXXXXXXXEXEXXXXXXXXXXXXXXXXXXX---XXXXXXXEXXXXXXXXXXXXXXXXXXXXXXX----------X