------------------------------------------------------------------------------------------------------------------------------------------------------
------------------------------------------------------------------------------------------------------------------------------------------------------
SSSSSSSSSSSSSSSSSSSSSSSSSSSSSSSSSSSSSSSSSSSSSSSSSSSSSSSSSSSSSSSSS-------------------------------------------------------------------------------------
------------S--SSSSSS--SSSS---------------------------------------------------------------------------------------------------------------------------
------------S--SSSSSS--SSSS----------------------------------------XXX--------------------------------------------------------------------------------
----------SS-------SS---S---------------------------------------------------------XXX----x-------------------------------------------------------QQQ--
----------SS-------SS---S-----------------------------------------------------------------x----------------------xxxxx--------------------------------
----------SS-------SS---S------------------------------------------------------------------x--------------------xx----x-------------------------------
--ooo-----SS---ooooSS---So???---------------------------------xxxxx-----SSSSS??-------------x------------------xxX-----x------------------------x-----
xx--------SSS--SSSSSS---SSS---------------------xxxx---------xxXXX-xxxx----------------------x-------ooo------xxEX------xxx------SSS-------------QQQQQ
>-x---------S----------------------------------xxSS-x-------xxEXXX-XXX-x----------------------x--------------xxXXX------<>-x--E-----------------------
]--x--------S----------------xxx------xxxx-xxxxx-SS--x-----xxXXXXX------x------xxx-------------x------------xxXXXX------[]--x---------------------E---
]---xxxxxxxxxxxxxxxxxxxxxxxxxx--xxxxxxx---xx--x--SS---xxxxxxXXXXXX-------xxxxxxx--xxxxxxxx----X-xxxxxxxxxxxxxXXXXX------[]---xxxxxxxxxxxxxxxxxxxxxxxxx
XXXXXXXXXXXXXXXXXXXXXXXXXXXXXX--XXXXXXX--XXX--X--XX--XXXXXXXXXXXX-------XXXXXXXX--XXXXXXXXXXXXXXXXXXXXXXXXXXXXXXXXXXXXXXXXXXXXXXXXXXXXXXXXXXXXXXXXXXXX