------------------------------------------------------------------------------------------------------------------------------------------------------
------------------------------------------------------------------------------------------------------------------------------------------------------
------------------------------------------------------------------------------------------------------------------------------------------------------
------------------------------------------------------------------------------------------------------------------------------------------------------
-------------------------------------------------------------------------------------------------------------------------E----------------------------
XXXXX---------------------------------------------------------------------------------------------------SSSSS---------XXXQQ?QQS-----------------------
-------------------------------------------------------------------------------------------------------S----------------------------------------------
------------------------------------------------------------------------------------------------------SS----------------------------------------------
---------------------------------------------------------------------------------B-------------------SSS--------------------------X-------------------
----------------------xxx------------------------------------------------B-------b------------------SSSS----------------------SSSSX----------------xx-
----------------------xB-x-------------------E---------------------------b--?-B------?QQ----------------------------------------------------------xB-x
x-xxx-----xxx--------xxb--x-----------------------------xxxxxx-----------B----b------------xxx-----xxx---------xxxx----------E-------------------xxb--
-xx--xxxxxxE-xxxxxxxxx-BEE-xxxxxxxxxxxxxxxxxxxxxxxxxxxxxxE-EE-xxxxxxxxxxxxxxxxxxxxxxxxxxxxxxE-xxxxxxB-xxxxxxxxxx---xxxxxxxxxxxxxxxxxxxxxxxxxxxxxxx-BEE
XXX--XXXXXXXXXXXXXXXXXXXXXXXXXXXXXXXXXXXXXXXXXXXXXXXXXXXXXXXXXXXXXXXXX>XXXXXXXXXXXXXXXXXXXX<>XXXXXXXXXXXXXXXXXXX---XXXXXXXXXXXXXXXXXXXXEXXXXXXXXXXXXXX