------------------------------------------------------------------------------------------------------------------------------------------------------
------------------------------------------------------------------------------------------------------------------------------------------------------
----------------------------------------------------------------x-------------------------------------------------------------------------------------
-----------------------------------------------------------------x------------------------------------------------------------------------------------
------------------------------------------------------------------x---------------------------------------------------E-------------------------------
-------------------------------------------------------------------x------------SSSSS----------------------------SSSSSSSSSSS-----------------------xxx
SSSSSS---------xxx--------------ES---------------E------------------x-----------------------------------------------------------------------------xxX-
---------------xB-x------S-------------QQQ------<>-------------------x---------------------------------------------------------------------------xx-X-
---xxxx-------xxb-------------------------------[]--------------------x---------------------xxxx---------------------------------X--------------xx-EX-
S-xx--xxx----xxXXX-xS------------------------QQQQQQQQQQ?---------X-----x-------------------xx<>-x-------------------xxx---SSSSSSSX--------------x--XX-
-xx------x--xxXXXX--x-----xxx--------------------------------?---X------x-----------------xx-[]--x------xxx--------xxX-x---------------------------XX-
xx--------xxxXXXXX---x---xxB-x-----------xxxxx-------------------X-------x-------xxxxx---xx--[]---x----xxB-x------xx-X--x--------------------------XX-
x----------xXXXXXX----xxxx-b--xxxxxxxxxxxxB---xxxxxxxx-X---------X------X-xxxxxxxx----xxxxE--[]----xxxxx-b--xxxxxxx--X---xxxxxxxxxxxxxxxxxxxxxxxxE-XX-
X------S---XXXXXXXXXXXXXXXXXXXXXXXXXXXXXXXX--XXXXXEEXXQXXXXXXXXXXXXXXXXXXXXXXXXXXX----XXXXXXXXXX---XXXXXXXXXXXXXXXXXXXXXXXXXXXXXXXXXXXXXXXXXXXXXXXXXXX