------------------------------------------------------------------------------------------------------------------------------------------------------
------------------------------------------------------------------------------------------------------------------------------------------------------
------------------------------------------------------------------------------------------------------------------------------------------------------
------------------------------------------------------------------------------------------------------------------------------------------------------
------------------------------------------------------------------------------------------------------------------------------------------------------
------------------------------------------------------------------------------------------SSSSSSS--------------------------------------------------SSS
B-----------------------------------------------------------------------------------------------------------------------------------------------------
b-----------------------------------------------------------------------------------------------------------------------------------------------------
xxxxxxx------------------------------------------------------------------------------------E--E--X---------X-EE-----X-------------ooo---------------E-
SSSSSS-x-------------------------------------------ooo------------------------------------SSSSSSSX---------XSSSSSSSQX-------------ooo-----------E--SSS
--------x------------------------------------------------------------------------Q?QQQ---------------------------------------------------------<>-----
---------x--xxx--------Exxx-------------xxxx---------xxx-----xxxx----------------------------xxx-------xxx--------------------------------------------
-EE---X---xxx--xxxxxxxxxx--xxxxxxxxxxxxxxEE-xxxxxxxxxx--xxxxxxEE-xxxxxxxxxxxxxxxxxxxxxxxxxxxxx--xxxxxxxx--xxxxxxxxxxxxxxxxxxxxxxxxxxxxxxxxxxxxxxxxxxxx
XXXXXXX---XXX--XXXXXXXXXX--XXXXXXXXXXXXXXXXXXXXXXXXXXX--XXXXXXXXXXXXXXXXXXXXXXXXXXXXXXXXXXXXXX--XXXXXXXX--XXXXXXXXXXXXXEEXEXXXXXXXXXXXXEEXEXXXXXXXXXXX