------------------------------------------------------------------------------------------------------------------------------------------------------
----------------------------------------------------------------------------------x-------------------------------------------------------------------
SSS---SSSSSSSSSSSSSSSSSSSSSSSSSSSSSSSSSSSSSSSSSSSS-------------SSS-[]SSSSSSSSSSSSSSx------------------------------------------------------------------
---------------------------SSSSSSSSSS------------------------------[]SSSSSSSSSSSSSS-x-----------------------------------------------------------------
-----------xxx-------------SSSSSSSSSS------------------------------[]SSSSSSSSSSSSSS--x------------------xxxxxxxxxxx----------E-E------------------xxxx
----xxxxxxxx--x------------SSSSSSSSSS--------------xx--xxxxx-------[]SSSSSSSSSSSSSS---x---------E------xx--QQQ?QQQ-x-------SSSSSSS-SS-xxxx-----xxxx--X
---xxSSSSSSS---xxxxx------------------------------xx-xxx----x------[]SSSSSSSSSSSSSS----x-------<>-----xx------------x-------------E--xx---x---xx--E--X
--xx-SSSSSSS--SSSSS-x----------------------------xx--XXX-----x-----[]SSSSSSSSSSSSSS-----x------[]----xx------E-------x--------------xx-----x-xx---XX-X
xxx--SSSSSSS--SSSSS--xxxxxxxxxxxxxxxxx-------xxxxx------------x-x---]SSSSSSSSSSSSSS-------------]--xxx-----SSSSSSS----x-----------xxx-------xx----XX-X
SSS--SSSSSSS--SSSSS?SS?????SSSSSSSSSS-x-----xx-XXX----------S--xSxx-]SSSSSSSSSSSSSS----E-x------]-xx<>--------------E--x---------xx<>-------<>----XX-X
SSS-------------------SSSSS------------x---xx-----------SSS-S--SSSSSSSSSSSSSSSSSSSS---->--x----->xx-[]-------X------X---x---E---xx-[]-------[]----XX-X
SSS---------<>--------SSSSS-------------x-xx------------SSS-S--SSSSSSSSSSSSSSSSSSSS----]---x----xx--[]-------X------X----x-----xx--[]-------[]----XX-X
SSS---------[]---------------------------xxX------------SSS-S--SSSSSSSSSSSSSSSSSSSS----]----xxxxx---[]----E--X------X-----xxxxxx---[]-------[]----XX-X
XXXXXXXXXXXXXXXXXXXXXXXXXXXXXXXXXXXXXXXEXXXX---------XXXSSS-S--XXXXXXXXXXXXXXXXXXXXXX--]XXXXXXXXXXXXXXXXXXXXXXXXXXXXXXXXXXXXXXXXXXXXX-------XX-XXXXX-X