------------------------------------------------------------------------------------------------------------------------------------------------------
------------------------------------------------------------------------------------------------------------------------------------------------------
-----------------------------------------------------------------xxxx-----------------E---------------------------------------------------------------
----------------------------------------------------------------xx---x--------------------------------------------------------------------------------
--------------------------------------E------------------------xx-----x----xxxxx----------------------------------------------------------------------
----------------SSS------------------SQS--SQS-----------------xx-------x--xxXXX-x---------------------------------------------------------------------
---------------------------xxxx-----------------------------xxx---------xxxXXXX--x----------------E---------------------------------------------------
--------------------------xxXX-x----------------------o-----xXX----------xEXXXX---x-------------------------------------------------------------------
?---------------SSS------xxXXX--x----------------------E----xXX----------XXXXXX----x--------------xx-xxx---------------------ooo----------------------
---ESSSS----------------xxXXXX---x---SQS--S?S-------SSSSS--xxXX---------XXXXXXX-----x------------xx-xx--x--------------------ooo----------------------
-----------------------xxXXXXX----x--------------E--E-----xxXXX-------EXXXXXXXX------x----------xx--XX---x--------------------------------------------
--------------xxxxx---xxXXXXXX-----x--------------------Exx-XXX-------XXXXXXXXX-------x--------xx---------x-------xxxx----------xxxx----------xxx---xx
xxxxxxxxxxxxxxx----xxxxXXXXXXX-----Exxxxxxxxxxxxxxxxxxxxxx--XXX------XXXXXXXXXX-------Xxxxxxxxxx-----------xxxxxxxxEE-xxxxxxxxxxx---xxxxxxxxxxx--xxxx-
XXXXXXXXXXXXXXX----XXXXXXXXXX--XXXXXXXXXXXXXXXXXXXXXXXXXXXXXXXX---XXXXXXXXXXXXXXXXXXXXXXXXXXXXXX----------XXXXXXXXXXXXXXXXXXXXXXX---XXXXXXXXXXX--XXXX-