------------------------------------------------------------------------------------------------------------------------------------------------------
------------------------------------------------------------------------------------------------------------------------------------------------------
--SSSSSSSSSSSSSSSS-------------SSS---[]SSSSSSSSSSSSS--------------------------------------------------------------------------------------------------
--SSSS-------------------------------[]SSSSSSSSSSSSS--------------------------------------------------------------------------------------------------
x-SSSS-------------------------------[]SSSSSSSSSSSSS--------------------------------------------------------------------------------------------------
-xSSSS-------------xx--xxxxx---------[]SSSSSSSSSSSSS-------------------------------SSS------------------------------SSS-----Q-------------------------
--x---------------xx-xxx----x--------[]SSSSSSSSSSSSS-----------------XX----------------------------X-X------------------------------------------------
---x-------------xx--XXX-----x-------[]SSSSSSSSSSSSS----------------XXX---------------------------XX-X------------------------------------------------
---oxxx------xxxxx------------x-------]SSSSSSSSSSSSS---------------XXXX--------------------------XXX-X--X---------------------xxx--xxxxx----------xxxx
--S?SS-x----xx-XXX----------X--xxxxxx-]SSSSSSSSSSSSS---------E----XXXXX--------E---SSS----<E----XXXX-X----------xxxxxxxxxxxxxxx--xxx--X-x------xxxxXXX
--SSS---x--xx-----------SSS-S--SSSSSSSSSSSSSSSSSSSSS----E---<>---XXXXXX-------<>----------[>---XXXXX-X---------xxXXXXXXXXXXXXXX---<>--XX-x----xxXXXX--
--SS-----xxx------------SSS-S--SSSSSSSSSSSSSSSSSSSSS---<>---[]--XXXXXXX-------[]----------[]--XXXXXX-X--------xxXXX---------------[]--XXX-x--xxXXXX---
----E-EE--xX------------SSS-S--SSSSSSSSSSSSSSSSSSSSS>--[]---[]-XXXXXXXX-------[]----------[]-XXXXXXX-X--------xXXXX---------------[]--XXXX-xxxXXXXX---
XXXX-XXXXXXX---------XXXSSS-S--XXXXXXXXXXXXXXXXXXXXX]--XX---XXXXXXXXXXXSXXXXXXXXXXXXXXXX--XXXXXXXXX--X-------XXXXX----------------XXXXXXXXXXXXXXXX----