------------------------------------------------------------------------------------------------------------------------------------------------------
------------------------------------------------------------------------------------------------------------------------------------------------------
------------------------------------------------------------------------------------------------------?-----------------------------------------------
-------------------------------------------------------------------------------------------------------------------------xxx--------------------------
--------------------------------------E--------------------------------------------------------------------------------xxx--x-------------------------
----S-----------------------------SSSSSS----S----------------------------------------SSSSS-------------------xxxxx----xxXS---x------------------------
--------------------------------------------------------------------------------------------------------SS--xx----x--xxEX-----x-----------------------
E--------------B-------------------------------------------------------------------------------------------xxX-----xxxXXX------x----------------------
>--------------b-------------------E-------------------------xxxxx--------------------E-------------SS----xxXX------xXXXXS------x------------------B--
]------------SSXSS-------xxxxx---SSSSSSS---xxxx------------xxx----x------------------SSSSS-xxx-----------xxXXX------XXXXX--------x---------B-------b--
------------------------xx-<>-x-----------xx<>-x----------xx<>-----xx---------xxxx--------xxX-x--B------xxXXXX-----XXXXXX---------x--------b--?-B-----
--xxx--------------B---xx--[]--x---------xx-[]--x------B-xx-[]----<>-x---B---xx<>-x------xx-X--x-b----xxxXXXXX----XXXXXXX----------x-------B----b-----
xxxB-xxxxxxxxxxxxxxxxxxx---[]---xxxxxxxxxx--[]---xxxxxxxxx--[]-E--[]--xxxxxxxx-[]--xxxxxxx--X---xxxxxxx-XXXXXX---XXXXXXXX---------X-xxxxxxxxxxxxxxxxxx
XXXX-XX-xBXXXXXXXXXXXXXX--XXXXXXXXXXXXXXXXXXXXXXXXXXXXXXXXXXXXXXXXXXXXXXXXXXXXXXXXXXXXXXXXXXXXXXXXXXXXX-XXXXXXXXXXXXXXXXXXXXXXXXX-XXXXXXXXXXXXXXXXXXXX