------------------------------------------------------------------------------------------------------------------------------------------------------
------------------------------------------------------------------------------------------------------------------------------------------------------
------------------------------------------------------------------------------------------------------------------------------------------------------
-------------------------------------------------------------------------------------------------------xxx--------------------------------------------
-----------------------------------------------------------------------------------------------------xxx--x-----------------------xxxxxxx-------------
----------------------------------------------------------------------------------------------------xxXX---x---------------------xx-SSSS-x------------
---------------------------------------------------------------------------------------------------xxXXX----x-------------------xx--------x-----------
--------------------------------------------------------------------------------------------------xxXXXX-----x-----------------xx----------x----------
-------------------------------E-----------------------------------------------------------------xxXXXXX------x---------------xxX-----------x--------x
----------------------ooo-----<>-------------------------------ooo------------------------------xxXXXXXX-------x-------S?S---xxEX---S-----X--x------xx
-----------------------------------------------------------------------------------------------xxXXXXXXX--------x-----------xxXXX---------X---x----xx-
xx--------xxxx----------xxx---------xxxxx-----------xxxx---------xxx-----xxxx------------------xXXXXXXXX---------x---------xxXXXX---------XX---x--xx--
--xxxxxxxxxEE-xxxxxxxxxxx--xxxxxxxxxx----xxxxxxxxxxxxEE-xxxxxxxxxx--xxxxxxEE-xxxxxxxxxxxxxxxxxxXXXXXXXXX--------X-xxxxxxxxxxXXXXX----EE---XX---Exxx---
X-XXXXXXXXXXXXXXXXXXXXXXX--XXXXXXXXXX---XXXXXXXXXXXXXXXXXXXXXXXXXX--XXXXXXXXXXXXXXXXXXXXXXXXXXXXXXXXXXXX-----XXXXXXXXXXXXXXXXXXXXXXXXXXXXXXXXXXXXXXXXX