------------------------------------------------------------------------------------------------------------------------------------------------------
------------------------------------------------------------------------------------------------------------------------------------------------------
------------------------------------------------------------------------------------------------------------------------------------------------------
-----------------------------------------------------------------------------------------------------------------------------------------------------x
---------------------------------------------------------------------------xxxxxxxxxxx----------E-E------------------xxxxx-----------------------xxxxx
XXXXX---------------------------------------------------------------------xx--QQQ?QQQ-x-------SSSSSSS-SS-xxxx-----xxxx--X-x---------------------xx---X
-------------------------------------------------------------------------xx------------x-------------E--xx---x---xx--E--X--x-------------------xx-E---
x----------------------------------------------------------B------------xx------E-------x--------------xx-----x-xx---XX-X---x----------------xxx------
-x-----------------------x-x-------------------------------b-----------xx-----SSSSSSS----x-----------xxx-------xx----XX-X----x--------------xx-E------
--x--------------x-------xx-x----------------------------SSXSS-------xx<>--------------E--x---------xx<>-------<>----XX-X-----x------------xx---------
---x--------------------xxB--x----------------E----B----------------xx-[]-------X------X---x---E---xx-[]-------[]----XX-X------x----------xx----------
----x-------xx---------xx-b---x--------------------b-----------B---xx--[]-------X------X----x-----xx--[]-------[]----XX-X-------S-------Xxx-----------
E---ExxxxxxxxXxxxxxxxxxx--BEE--xxxxxxxxxxxxxxxxxxxxxxxxxxxxxxxxxxxxx---[]----E--X------X-----xxxxxx---[]-------[]----XX-X-------xxxxxxxxxx------------
XXXXXXXXXXXXXXXXXXXXXXXXXXXXXXXXXXXXXXXXXXXXXXXXXXXXXXXXXXXXXXXXXXXX--XXX-XXXXXXXXXXXXXXXXXXXXXXXXXXXXXX-------XX-XXXXX-XXXXXXXXXXXXXXXXXX--------XXXX