-----------------------------------------------------------------------------------------------------------------------------xxx----------------------
--------------------------------------------------------------------------------xx----------------------------------------------x---------------------
-------------------------------------------------------------------------------xx-x----------------------------------------------x--------------------
------------------------------------------------------------------------------xx---x-----xxx--------------------------------------x-----xxx-----------
------------------------------------------------------------------------xxxxxxx-----xxxxxx--x--------------------------xxxxxxx-----xxxxxx--x----------
-----------------XXXXX-----------------------------------------------xxxx---XXX-----XXXXXXE--x------------------------xxXXXXXX-----XXXXXXE--x---------
S-------------------------------------------------------------------xxXXX---------------------x-------------E--------xx----------------------x--------
X------------------------------------------------------------------xx--------------------------x--------------------xx------------------------x-------
X--X----------------------------------------------------------xxxxxx----------------------------x-----------xx-xxxxxx--------------------------x------
X-------------------------------X---------------x------------xx-XXXX--------XXX------------------x---------xx-xx--XXX---------------------------x-----
X--------xxx--------------------X----------------xx---------xx------------------------------------xxxxxx--xx--XX---------------------------------xxxxx
X--------xB-x-----xxx--------SSSX------xxx-------X-x-------xx--------------------------------------x----xxx---------------------------------------x---
X---------b--xxxxxxX-xxxxxxxxxxxxxxxxxxx--xxxxxxxX--xxxxxxxx-------------------------------XXXXEXXEX----XXX-------------------------------XXXXEXXEX---
X----XXXXXXXXXXXXXXXXXXXXXXXXXXXXXXXXXXX--XXXXXXXX--XXXXXXXX------------------------------------------------------------------------------------------