-x----------------------------------------------------------------------------------------------------------------------------------------------------
------------------------------------------------------------------------------------------------------------------------------------------------------
------------------------------------------------------------------------------------------------------------------------------------------------------
------------------------------------------------------------------------------------------------------------------------------------------------------
---xxxx-----------------------------------------------------------------------------------------------------xxxx--------------------------------------
--xx?SSx---------------------------------------------SSSSSSS---------------E-------------------------------xx---x-------------------------------------
-xx-----x---------------------------------------------------------------E-----xxx--------E----------------xx-----x------------------------------------
-xE------x----------------------------------------------------------xxxxxxxxxxxX-x---xxxxx------------xxxxx-------x-----------xxxxxx-----oooo---------
-<>-------x------------------B------------------------E--E---------xxXSSSSSSSSS?--xxxx----x--------xxxx--xE--------x--xxx---xxx--x--x----oooo--------x
-[]--------x---------B-------b-----------------------SSSSSSS------xxXX------------XXXX-----x------xxXXX--<>---------xxxS-x-xxXX--X---x--------------xx
-[]---------x--------b--?-B------?QQ---------oooQ----------------xxXXX----oooooooo----------xE---xx------[]----------x----xxXXX--X----xxxxxxxxxxxxxxx-
x[]----------x-------B----b-----------------------------xxx-----xxXXXX-----------------------x--xx-------[]----------SS-SSxXXXX--X----XXXXXXXXXXXXXXX-
X[]---------X-xxxxxxxxxxxxxxxxxxxxxxxxxxxxxxxxxxxxxxxxxxx--xxxxxxXXXXX----oooooooo------------xxx--------[]--------X-SS-SSXXXXX--X----X-------------X-
XXXXX-----XXXXXXXXXXXXXXXXXXXXXXXXXXXXXXXXXXXXXXXXXXXXXXX--XXXXXXXXXXXXXXXXXXXXXXX-----------XXXXXXX-----[]---XXXXXXXXXXX-XXXXX--X----X-------------X-