-xxx--------------------------------------------------------------------------------------------------------------------------------------------------
xx--x---------------------------------------------------------x---------------------------------------------------------------------------------------
x----x------------------------------------------------------------------------------------------------------------------------------------------------
------x------xxx--------------------------------------------------------------------------------------------------------------------------------------
-------x-xxxxx--xxxx----------------------------------------------------------------------------------------------------------------------------------
--------xx--XX--XXX-x--EXXXX---------XXXXXXXXXXXXXXXX-----------------X-----------------------QQ------------------E----------SSSSS-----?--------------
--------XX-----------x-------------------[]-------[]-------------------------------------------------------------<>-----------------------------------
----------------------x------------------[]-------[]----------------X--------------------------------------------[]-----------------------------------
----------------------oxxxxxxx-----------[]-------[]----------xxx------------------------------------X-----------[]--------------X-------------xxx----
?--------------------S?SSSSSS-x----------[]-------[]---------xx<-x------------------------------SSSSSX------SQS--[]-----------EXXX------------xx--x---
---------------------SSS-------x---------<>-------<>--------xx-[]-x----------------------------------------------------xxxx---------------xxxxx----xxx
---------------------SS---------x--------xxx------xxx------xx--[]--x-----------xx--------------E----------------------xx<>-x-------------xx--x-----XXX
oo---------------------E---------xxxxxxxxxE-xxxxxxxE-xxxxxxx---[]---xxxxxxxxxxxxXxxxxxxxxxxxxxxxxxxxxxxxxxxxxxxxxxxxxxx-[]--xxxxxxxxxxxxxx---B-----XX-
XX--------------XXXXXXX-XXXXXX---XXXXXXXXXX-XXXXXXXX-XXXEXXXX--XXXXXXXXXXXXXXXXXXXXXXXXXXXXXXXXXXXXXXXXXEEXEXXXXXXXXXXXXXXXXXXXXXXXXEEXXXXXXXX-----XX-