---------------------------------------------------------------------------------------xxx------------------------------------------------------------
-------------------------------------------------------------------------xxxxxxxxxxxxxxx--x-----------------------------------------------------------
----------------------------------------x--------------------------------xXXXXXXXXXXXXXX---x----------------------------------------------------------
-----------------------------------------x------------------------------xxXXXXXXXXXXXX-X----x---------------------------------------------------------
-------------------------------------XXX--x--------------E-------------xx-XXXXXXXXXXXX-X-----x-----------------------xxxxxxx--------------------------
-------------------------------------------x-----E-SSSSS---------------xS-XXXXXXXXXXXXXX------x---------------------xx-SSSS-x-------------------------
--------------------------------------------x-E------------------------x--XXXXXXXXXXXXXX-------x-------------------xx--------x---------------------E--
---------------------------------------------x------------------------xx--XXXXXXXXXXXXXX--------x-----------------xx----------x-----------------------
----------------------------------------------x----------------------xxS--XXXXXXXXXXXXXX---------x---------------xxX-----------x--------xxxx----------
?QQQQQQQ?--------------------------------------x----SSS--------------x----XXXXXXXXXXXXXX----------x-------S?S---xxEX---S-----X--x------xx<>-x---------
----------------E-------------------------------x-------------------xx----XXXXXXXXXXXXXX-----------x-----------xxXXX---------X---x----xx-[]--xx-------
B------------------------------------------------x-----------------xx---E-XXXXXXXXXXXXXX------------x---------xxXXXX---------XX---x--xx--[]---Bx------
b-E-----B-----------X--------E-E------------------xxxxxxxxxxxxxxxxxx------XXXXXXXXXXXXXX-----------X-xxxxxxxxxxXXXXX----EE---XX---Exxx---[]---b-xxxxxx
XXXXXX-XXXXXXX---XXXXXX------xXXXXX---------------XXXXXXXXXXXXXXXXXXXXXXXXXXXXXXXXXXXXXX--XXXXXXXXXXXXXXXXXXXXXXXXXXXXXXXXXXXXXXXXXXXXXXXXXXXXXXXXXXXX