------------------------------------------------------------------------------------------------------------------------------------------------------
------------------------------------------------------------------------------------------------------------------------------------------------------
------------------------------------------------------------------------------------------------------------------------------------------------------
--------------------------------------------------------------------------------xxx-------------------------------------------------------------------
------------------------------------------------------------------------------xxx--x------------------------------------------------------------------
-----------------------------------XX----------------------------E-----------xxXX---x-------------------------------------------------SSSSSSSSSSSSS---
-----------------------------------[]---------------------------<>----------xxXXX----x---------ES------E----------------------------------------------
--------------oo--o----------------[]---------------------------[]---------xxXXXX-----x--------------QQQQ---------------------------------xxxxxxx-----
-------------------------xx--------[]---------------------------[]--------xxXXXXX------x------------------xxxx---Q--Q-?-----------------xxxSSSSS-x----
-xxxxxxxxxxxxxxxxx------xx-xxx-----<>SSSSSS-----------------E--S[]SS-xxxxxxXXXXXX--------xx--------------xx<>-x-------------S---------xxxSS-------x--Q
xxXX<>XXXXXXXXXXX-x----xx--XX-x----------------------------<>-------xxE--xXXXXXXX-------x]-x------------xx-[]--x----------E----------xx<>----------x--
xXXX[]X------------xxxxx---X-X-xx---Exxx---------------------------xx<>-XXXXXXXXX-------B]--x----------xx--[]---x-----E-----xxxxxx--xx-[]-----------x-
XXX--]X------------XXXXX---X-XXX-xxxxxE-xxxxxxxxxxxxxxxxxxxxxxxxxxxx-[]-XXXXXXXXX-------b]---xxxxxxxxxxx---[]----xxxxxxxxxxxx---X-xxx--[]----E---EE--x
XX---]X--------------------X-XXXXXXXX<>XXXXXXXXXXXXXXXXXXXXXXXXXXXXXXXXXXXXXXXXXXXXXXXXXXXXXXXXXXXXXXXXXXXXXXXXXXXXXXXXXXXXXX---XXXXXXXXXXXXXXXXXXXXXX