------------------------------------------------------------------------------------------------------------------------------------------------------
-----------------------------------------------------------------------------xx-----------------------------------------------------------------------
----------------------------------------------------------------------------xx-xxx--------------------------------------------------------------------
---------------------------------------------------------------------------xx--XX-x-------------------------------------------------------------------
--------------------------------------------------------------------------xx---XX--x------------------------------------------------------------------
---------------------------E-------------------------SSSSS---?-------xxx--xS---XX---x-----------------------------------------------------------------
-------xxxx---------------------------------------------------------xx--x-x----XX----x----------------------------------------------------------------
-o-----xXX-x-------------------------------------------------------xx----xx----XX-----x------------------------------------------------------------xxx
--E----xXX--x-----------------------------------------------------xx------x----XX------x---------------?----------------E-------------------------xx--
SSSS--xxXX---x----------------------------xxx-----S---E---------xxx-------SS---XX-------x---------QQQ-----ESSS----E----<>-------------------E-xxxxx---
-----xxXXX----x--------------------------xxX-x-------------E---xx<>------------XX--------x-----------------------<>------------------------<>xxX-x----
---Exx-XXX-----xx-------xxx--xxx-------Exx-X--x---------------xx-[]------------XX---------x--------E-------------------------xxxxx----------xx-X-S-S--
xxxxx--XXX-----X-xxxxxxxx--xxx--xxxxxxxxx--X---xxxxxxxxxxxxxxxx--[]E-----------XX--------X-xxxxxxxxxxxxxxxxxxxxxxxxxxxxxxxxxxx----xxxxxxxxxxx--X-S-S--
XXXXXXXXXX--XXXXXXXXXXXXX--XXX--XXXXXXXXX--XXXXXXXXXXXXXXXXXXXXXXXXXXXXXXXXXXXXXXXXXXXXXXXXXXXXXXXXXXXXXXXXXXXXXXXXXXXXXXXXXXX---XXXXXXXXXXXXXXXXXXXXX