------------------------------------------------------------------------------------------------------------------------------------------------------
------------------------------------------------------------------------------------------------------------------------------------------------------
------------------------------------------------------------------------------------------------------------------------------------------------------
------------------------------------------------------------------------------------xxx---------------------------------------------------------------
----------------------------------------------------------------------------------xxx--x--------------------------------------------------------------
----------------------------------------------------xxxE-----oo------------------xxXX---x-------------------------------------------------------------
--x----------------------------------------------xxxx--x-------------XXX--------xx-XX----x----------------ES------E-------E---------------------------
--Xxxx------------------------------------------xxXXX---x---xxx----------------xxXXXX-----x--------S------------QQQ------<>------------------xxx------
-xXx--x----------------------------------------xx--------xxxx--xxxxx----------xx-XXXX------x-----------------------------[]--------<>-------x<>-x---Q-
-xXS---xxx-------------------E--S-------------xxX--------XXXX--XXXX-x--------xxXXXXXX-------x-------------------------QQQQQQQQQQ---[]------xx[]--x----
xxX----[>-x----------------E->----------E----xxXXX-------------------x------xx-XXXXXX--------x------xxx-----------------------------------xx-[]---x---
x-X----[]--x---------------------------<>---xxXXXX--------------------x----xx--XXXXXX---------x----xxB-x----------xxxxx------------------xx--[]----x--
E-Xo?--[]---xxxxxxxxxxxxxxxxxxxxxxxxxxxxxxxxxXXXX-----ooo--------------xxxxx---XXXXXX--------X-xxxxx-b--xxxxxxxxxxxB---xxxxxxxxxxxxxxxxxxx---[]-----xx
XXXXX---]XXXXXXXXXXXXXXXXXXXXXXXXXXXXXXXXXXXXXXXX-----XXX-------------XXXXXXXXXXXXXXXXXXXXXXXXXXXXXXXXXXXXXXXXXXXXXX--XXXXXEEXXXXXXXXXXXXXXXXXXXXXXXXX