------------------------------------------------------------------------------------------------------------------------------------------------------
------------------------------------------------------------------------------------------------------------------------------------------------------
--------------------[]SSSS-------------------------------------------------------------------------------------------------------------------------?--
--------------------[]SSSS----------------------------------------------------------------------------------------------------------------------------
--------------------[]SSSS-------xxxxxxxxxxx----------E-E------------------xxxxx----------------------------------------------------------------------
--xx----------------[]SSSS------xx--QQQ?QQQ-x-------SSSSSSS-SS-xxxx-----xxxx--X-x-------------------------------------------------SSSSS---------------
-xx-x---------------[]SSSS-----xx------------x-------------E--xx---x---xx--E--X--x-----------------------E-------------------------------------------S
xx---x--------------[]SSSS----xx------E-------x--------------xx-----x-xx---XX-X---x---------------------<>--------------------------------------------
x-----xxxxxxxxxx-----]SSSS--xxx-----SSSSSSS----x-----------xxx-------xx----XX-X----x--------------------[]-------------------------E-------------SS---
S---SSSSSSS?SSX-x----]SSSS-xx<>--------------E--x---------xx<>-------<>----XX-X-----x-----------X-------XXX-----------------------SSSSS-xxx-----------
S-------SSSSSSX--x--S]SSS-xx-[]-------X------X---x---E---xx-[]-------[]----XX-X------x-----S---XX-------------xxxx---------xxxx--------xxX-x--B------x
S-------SSSSSSX--SSSSSSSSxx--[]-------X---S--X----x-----xx--[]-------[]----XX-X-------S-----S-SXX---xxx----B-xx<>-x---B---xx<>-x------xx-X--x-b----xxx
S----------XX-X--SSS--xxxx---[]----E--X------X-----xxxxxx---[]-------[]----XX-X-------xxxxxxxxxxxxxxx--xxxxxxx-[]--xxxxxxxx-[]--xxxxxxx--X---xxxxxxx-X
XXXXXXXXXX-XX-X--XXXXXXXXXXXXXXXXXXXXXXXXXXXXXXXXXXXXXXXXXXXXX-------XX-XXXXX-XXXXXXXXXXXXXXXXXXXXXXX--XXXXXXXXXXXXXXXXXXXXXXXXXXXXXXXXXXXXXXXXXXXXX-X