------------------------------------------------------------------------------------------------------xxx---------------------------------------------
--------------------------------------------------------------------------xxxxxxxxxxxxxxxxxxxxxxxxxxxxx--x--------------------------------------------
SSSSSSSSSSSSSSSSSSSSSSSSSSSS---------------------------------------------xxXXXXXXXXXXXXXXXXXXXXXXXXXXXX---x-------------------------------------------
------------------------------------------------------------------------xxXXXXXXXXXXXXXXXXXXXXXXXXXXXXX----x------------------------------------------
------------------------------XXX--------------------------------------xx-XXXXXXXXXXXXXXXXXXXXXXXXXXXXX-----x-x---------------------------------------
---------------------------------------------XXX----SSS---?-------xxx--xS-XXXXXXXXXXXXXXXXXXXXXXXXXXXXX------xx---------------------------------------
-----------------------------------------------------------------xx--x-x--XXXXXXXXXXXXXXXXXXXXXXXXXXXXX-------<x--------------------------------------
xxx-------------------------------------------------------------xx----xx--XXXXXXXXXXXXXXXXXXXXXXXXXXXXX---------x-------------------------------------
x--x---------------------xxxxx-----SSSSS??---------------------xx------x--XXXXXXXXXXXXXXXXXXXXXXXXXXXXX----------x-------------Q--?-------------------
>---x------xxxx---------xxXXX-xxxx---------------------------xxx-------SS-XXXXXXXXXXXXXXXXXXXXXXXXXXXXX-----------x---------Q-E------ESSS----E-------x
]----xxx--xxSS-x-------xxEXXX-XXX-x---------------------E---xx<>----------XXXXXXXXXXXXXXXXXXXXXXXXXXXXX------------x----------E-------------<>-----xxx
]----<>-xxx-SS--x-----xxXXXxX------x------xxx--------------xx-[]----------XXXXXXXXXXXXXXXXXXXXXXXXXXXXX-------------x-----------------------------xx<>
]--E-[]--x--SS---xxxxxxXXXXXX-------xxxxxxx--xxxxxxxxxxxxxxx--[]E---------XXXXXXXXXXXXXXXXXXXXXXXXXXXXX------------X-xxxxxxxxxxxxxxxxxxxxxxxxxxxxxx-[]
XXXXXXXXXX--XX--XXXXXXXXXXXX-------XXXXXXXX--XXXXXXXXXXXXXXXXXXXXXXXXXXXXXXXXXXXXXXXXXXXXXXXXXXXXXXXXXX--XXXXXXXXXXXXXXXXXXXXXXXXXXXXXXXXXXXXXXXXXXXXX