------------------------------------------------------------------------------------------------------------------------------------------------------
------------------------------------------------------------xx----------------------------------------------------------------------------------------
-----------------------------------------------------------xx-xxx-------------------------------------------------------------------------------------
----------------------------------------------------------xx--XX-x------------------------------------------------------------------------------------
---------------------------------------------------------xx---XX--x-----------------------------------------------------------------------------------
---------------------------------------------------------xS---XX---x-------------------------------------------------------------------------------x-E
---------------------------------------------------------x----XX----x------------------------------------------------------------------------------XXX
-----------------------------------------------------xxxxx----XX-----x----------------------------------------------------------------------------xxxx
------------------------------xxxx-----------------xxx---x----XX------x-------------Q--?--------------------E------------------------------------xx---
QQQQ-------------------S?S---xxXX-x---------------xx<>---SS---XX-------x---------Q-E-----SSS----E-----E----<>-------------------E--S------------xxX---
-------B-----E---B----------xxEXX--x--B-----E---Exx-[]--------XX--------x----------E-----------<>----<>------------------------<>---------E----xxXXX--
E------b---------b---------xxXXXX---x-b---------xx--[]--------XX---------x---------------------------------------xxxxx-------------------<>---xxXXXX--
xxxxxxxxxxxxxxxxxxxxxxxxxxxxXXXXX----xxxxxxxxxxxx---[]--------XX--------X-xxxxxxxxxxxxxxxxxxxxxxxxxxxxxxxxxxxxxxxx----xxxxxxxxxxxxxxxxxxxxxxxxxXXXX---
XXXXXXXXXXXXXXXXXXXXXXXXXXXXXXXXXXXXXXXXXXXXXXXXXXXXXXXXXXXXXXXXXXXXXXXXXXXXXXXXXXXXXXXXXXXXXXXXXXXXXXXXXXXXXXXXXX---XXXXXXXXXXXXXXXXXXXXXXXXXXXXXX---