------------------------------------------------------------------------------------------------------------------------------------------------------
------------------------------------------------------------------------------------------------------------------------------------------------------
------------------------------------------------------------------------------------------------------------------------------------------------------
------------------------------------------------------------------------------------------------------------------------------------------------------
----------------------------------x---------E---------------------------------------------------------------------------------------------------------
E----------------------------------xSSSSSSSSSSSS------------------------------------------------------------------------------------------------------
------------------------------------x-----------------------------------------------------------------------------------------------------------------
-------------------------------------x----------------------------------------------------------------------------------------------------------------
--------------------------------------x-----E-------X---------------X--------------ooo-----------------------E--------------------------------------xx
QQ------------------xxx----------------x----QQ?QQQQQX---------------XS-------------ooo----------SSS----E----<>--------------------E--S-------------xxX
--------------------xB-x----------------x-------------------------------------------------------------<>-------------------------<>--------QE-----xx-X
xxxxx---xxx--------xxb--x----------------x----------------xxx------------------------------------------------------xxxxx-------------------<>----xxXEX
X----xxxxE-xxxxxxxxx-BEE-xxxxxxxxxxxx-----xxxxxxxxxxxxxxxxx-Exxxxxxxxxxxxxxxxxxxxxxxxxxo--------xxxxxxxxxxxxxxxxxxxx----xxxxxxxxxxxxxxxxxxxxxxxxxxXXXX
X----XXXXXXXXXXXXXXXXXXXXXXXXXXXXXXXXXXXXXXXXXXXXXXXXXXXXXX--XXXXXXXXXXXEEXEXXXXXXXXXXXXXEEXX-XXXXXXXXXXXXXXXXXXXXXX---XXXXXXXXXXXXXXXXXXXXXXXXXXXXXXX