------------------------------------------------------------------------------------------------------------------------------------------------------
------------------------------------------------------------------------------------------------------------------------------------------------------
------------------------------------------------------------------------------------------------------------------------------------------------------
------------------------------------------------------------------------------------------------------------------------------------------------------
------------------------------------------------------------------------------------------------------------------------------------------------------
---------------------------------------------------------------------------------------------E----------------------?----------------SSS------?SS-----
--------------------------------------------------------------------------------------------X---------------------------------------------------------
--------------------------------------------------------------------------------------------X---------------------------------------------------------
---------------------------------------------------------------------------------------X----XE----X---------SSS-------------xx------------------------
?QQQQQQ?-------------------------?QQQQQQ-Q?----------------------XS--------------------X---]XQQ?QQX------------------------xx-x-----------------------
------------------------------------------------------------XXXXXXx--------------------X----------------B--------E--------xx---x-----------E---B------
B------------------------?--------------------------?--------------x------------------SX----------------b------------xxxxxx-----x--------------b------
b-E----B--------E----------------B-E------B-----E-------E--------E--xxxxxxxxxxxxxxxxxxxxxxxxxxxxxxxxxxxxxxxxxxxxxxxxxxB--x-----X-xxxxxxxxxxxxxxxxxxxxx
XXXXXXXXXXX---XXXXXXEXEXX-XXXXXXXXXXXXXX-XXXXXXXXXXX-XXXXXXXXXXXXXXXXXXXXXXXXXXXXXXXXXXXXXXXXXXXXXXXXXXXXXXXXXXXXXXXXXX--X---XXXXXXXXXXXXXXXXXXXXXXXXX