------------------------------------------------------------------------------------------------------------------------------------------------------
-----------------------------------------------------------------------xxx----------------------------------------------------------------------------
------------------------------------------E---------------------------xx--x---------------------------------------------------------------------------
---------------------------------------------------------------------xx----xx-------------------------------------------------------------------------
--------------------------------------------------------------------xx-----E-xxxxxx-------------------------------------------------------------------
----------------------------------SSSSSSSS?S--------S----S--------xxx---------x----x-------SSSSSSS----------XXXXXXXXXXXXXXXX--------------------------
-----ES--------------E-------------[]----------------------------xx-S--------<>-----x-----------------------------------------------------------------
------------QQ------<>-------------[]---------------------------xx-----------[]------xxxx--------xxx--------------------------------------------------
--------------------[]-------------[]--------------xxxx--------xx------------[]-------xB-xxxxxxxxx--x-------------------------------------------------
-----------------QQQQQQQQQQ--------[]-------------xx<>-x------xx-------X-----XX-------XXXXESSSSSSS---x-----------------------------------------------x
xx---------------------------------<>------------xx-[]--x----xxE---------------------XXXXXX-----------x--------------------------------QQQQQoX?-----xx
B-x----------xxxxx-----------------xxx----------xx--[]---x--xx<>--------------------XXXXXXX------------x---------xxx-xxx-xxx-----xxx---------------xx-
b--xxxxxxxxxxxB---xxxxxxxxxxxxxxxxxxE-xxxxxxxxxxx---[]----xxx-[]-----X-------------XXXXXXXX-----------B-xxxxxxxxxx--xx--xx--xxxxxxE-xxxxxxxxxxxxxxxxX-
XXXXXXXXXXXXXXX--XXXXXEEXXXXXXXXXXXXXXXXXXXXXXXXXXXXXXXXXXXXXXXXXXXXXX-------------XXXXXXXXXXXXXXXXEXXXXXXXXXXXXXX--XX--XX--XXXXXXXXXXXXXXXXXXXXXXXXX-