------------------------------------------------------------------------------------------------------------------------------------------------------
------------------------------------------------------------------------------------------------------------------------------------------------------
------------------------------------------------------------------------------------------------------------------------------------------------------
------------------------------------------------------------------------------------------------------------------------------------------------------
------------------------------------------------------------------------------------------------------------------------------------------------------
------------------------------------------------------------------------------------------------------------------------------------------------------
E-----------------------E------------------------------------------------------------------------E----------------------------------------------------
>----------------------<>-----------------------------------------------------------------------------------------------------------------------------
-------------xxxxxx----[]---------------------------------------------------------E--------------xx--------xxx-------------E--------------------------
xx----------xxXSSS-x---XX---------------------------------E----------------------<>-------------xx-xxxxxxxxx--x---oooooooo<>-------?QQQQQQ?-----------
S-x--------xx-X-----x--------xxxx---------?QQ------------------------------------[-----------xxxx--XXXXXXXXX---x--oooooooo[]--------------------------
S-Sx------xx--X------x----B-xx<>-x---B----------xxx--------xxx-------Exxx---------xxx-----xxxxXXX---------------xxxxxxxxxx[]---<>--------------------?
o-S-xxxxxxxE-EX-------xxxxxxx-[]--xxxxxxxxxxxxxxx--xxxxxxxxx--xxxxxxxxx--xxxxxxxxxx--xxxxxxXXXXXX--------------XXXXXXXXX--[]---[]--B-E----B------E----
XXXXXXXXXXXXXXXXXXX---XXXXXXXXXXXXXXXXXXXXXXXXXXX--XXXXXXXXX--XXXXXXXXX--XXXXXXXXXX--XXXXXXXXXXX---------------XX----------]---[]--bXXXX-XXXXXXXXXXXX-