------------------------------------------------------------------------------------------------------------------------------------------------------
----------------------------------------------------------------------------------------xxx-----------x-----------------------------------------------
-----------------------------------------------------------E---------------------------xx--x----------------------------------------------------------
--------------------------------------------------------------------------------------xx----xx--------------------------------------------------------
----------------------------------------------------------x--------------------------xx-----E-xxxxxx--------------------------------------------------
---------------------------------------------------SSSSSSSS?S--------S----S--------xxx---------x----x-------SSSSSS----------XSXXXXXXXXXXXXXX----------
----xxx--------------ES--------------E--------------[]----------------------------xx-S--------<>-----x--------------------------[]-------[]-----------
----xB-x------S------------QQQ------<>--------------[]---------------------------xx-----------[]------xxxx-------xxx------------[]-------[]-----------
Q--xxb------------------------------[]--------------[]--------------xxxx--------xx------------[]-------xB-xxxxxxxx--x-----------[]-------[]-----------
--xxXXX-xS-----------------------QQQQQQQQQQ---------[]-------------xx<>-x------xx-------X-----XX-------XXXXESSSSSS---x----------[]-------[]-----------
ExxXXXX--x-----xxx----------------------------------<>------------xx-[]--x----xxE---------------------XXXXXX----------x---------<>-------<>----------x
xxXXXXX---x---xxB-x----------xxxxx------------------xxx----------xx--[]---x--xx<>--------------------XXXXXXX-----------x--------xxx------xxx--------xx
xXXXXXX----xxxx-b--xxxxxxxxxxxB---xxxxxxxxxxxxxxxxxxxE-xxxxxxxxxxx---[]----xxx-[]-----X-------------XXXXXXXX----------B-xxxxxxxxxE-xxxxxxxE-xxxxxxxxx-
XXXXXXXXXXXXXXXXXXXXXXXXXXXXXXX--XXXXXEEXXXXXXXXXXXXXXXXXXXXXXXXXXXXXXXXXXXXXXXXXXXXXXX-------------XXXXXXXXXXXXXXXEXXXXXXXXXXXXXX-XXXXXXXX-XXXEXXXXXX