------------------------------------------------------------------------------------------------------------------------------------------------------
--xxxx------------------------------------------------------------------------------------------------------------------------------------------------
--x-x-xxx-------------------S-------------------------------------------------------------------------------------------------------------------------
-xx---XX-x------------------]-------------------------------------------xxx-----------------------------------------------------------------------xxx-
xx----XX--x-----------------]-----------------------------------------xxx--x--------------------------------------------------------------------xxx--x
xS----XX---x---------------X]-------------XXXX-----------------------xxXX---x----------------------------------------x-------------------------xxXX---
------XX----x--------------[]--------------------------------------x-x-XX----x----------------------------------------------------------------xxXXX---
------XX-----x-------------[]--------------------------------------XXX-XX-----x-----------------------------------------------------------xxxxxXXXX---
------XX------x------------[]-----------------------------------------EXX------x------------------B--------------------------------------xx--xXXXXX---
------XX-------x----------Q[]-------------------------------------xxx<>XX-------x---------B-------b-------------------------------------xx---XXXXXX---
------XX--------x----------<>----xxx-----------------------------xxX-[]XX--------x--------b--?-B------?QQ------------------------------xx----XXXXXX---
------XX---------x--------------xxB-x-------------xxx-xxx------Exx-XX[]XX---------x-------B----b----------------------xxx------xxxxxx-xx-----XXXXXX---
------XX--------X-xxxxxxxxxxxxxxx-b--xxxxxxxxxxxxxx--xx--xxxxxxxx--XX[]XX--------X-xxxxxxxxxxxxxxxxxxxxxxxxxxxxxxxxxxxx--xxxxxxx--EE-xxX-----XXXXXX---
XXXXXXXXXXXXXXXXXXXXXXXXXXXXXXXXXXXXXXXXXXXXXXXXXXX--XX--XXXXXXXX--XXXXXXXXXXXXXXXXXXXXXXXXXXXXXXXXXXXXXXXXXXXXXXXXXXXX--XXXXXXX--XXXXXX-----XXXXXXXXX