---------------------------------------------------------------------------------------------------------------------------------xxx------------------
------------------------------------------------------------------------------------------------------------------------xxxxxxxxxx--x-----------------
-----------------------------------------------------------------------------------------------------------------------xxXXXXXXXXX---x----------------
----------------------------------------------------------------------------------------------------------------------xxXXXXXXXXXX----x---------------
---------------------------------------------------------------------------------------------------------------------xx-XXXXXXXXXX-----x--------------
xxx------------------XX-----------------------------------xxxx-------------SS-------x------------SSSS----------------xS-XXXXXXXXXX------x-------------
<>-x-----------------[]-----------------------------------x<>-x----------------------x------------[]-----------------x--XXXXXXXXXX-------x------------
[]--x----------------[]-----------------------------------x[]--x----------------------x-----------[]--------------xxxx--XXXXXXXXXX--------x-----------
[]---x----xxxx-------[]-----------------------------E----xx[]---x----------------------x----------[]-------------xx--x--XXXXXXXXXX---------x----------
[]----x--xx---xx-----<>SSSSSS---------------------------xxS[]----x---------xx-----------xx--------[]------------xx---SS-XXXXXXXXXX----------x---------
[]-----xxx----X-x-------------------------------oo-----xx--[]-----x-------xB-x----------B-x-------<>----------xxx-------XXXXXXXXXX-----------x--------
[]------x-----XX-xx---Exxx----------------------oo----xx---[]------x-------b--x---------b--x------xxx--------xx<>-------XXXXXXXXXX------------x-------
[]------B-----XXXX-xxxxxE-xxxxxxxxxxxxxxxxxxxxxxxxxxxxx----[]-------xxxxxxxBE--xxxxxx---B---xxxxxxxE-xxxxxxxxx-[]-------XXXXXXXXXX-----------X-xxxxxxx
XXXXXXXXX-----XXXXXXXXX<>XXXXXXXXXXXXXXXXXXXXXXXXXXXXXXXXXXXXXXXXXX-XXXXXXXXXXXXXXXXXXXXXXXXXXXXXXXXXXXXEXXXXXXXXXXXXXXXXXXXXXXXXX--XXXXXXXXXXXXXXXXXX