----------------------------------------------------------xxx-----------------------------------------------------------------------------------------
-----------------------------------------------xxxxxxxxxxxx--x----------------------------------------------------------------------------------------
-----------------------------------------------xXXXXXXXXXXX---x------------------------------------------------------------S--------------------------
-----------xxx--------------------------------xxXXXXXXXXXXX----x--------------------------------------------------------------------------------------
---------xxx--x--------------E---------------xx-XXXXXXXXXXX-----x----------------------------------------SSSS---------------------E-------------------
--------xxXX---x-----E-SSSSS-----------------xS-XXXXXXXXXXX------x----------------------------------------------------SSSSSS----QQQQQQQQ--------------
-------xxXXX----x-E--------------------------x--XXXXXXXXXXX-------x----------------X--E-X-------------------------------------------------------------
---xxxxxXXXX-----x--------------------------xx--XXXXXXXXXXX--------x--------------XX----X-------------------------------------------------------------
--xx--xXXXXX------x------------------------xxS--XXXXXXXXXXX---------x-------------XXE---X--------X-EE-------X----------------------E-----------------X
-xx---XXXXXX-------x----SSS----------------x----XXXXXXXXXXX----------x-----------XXXQQ?QX--------XSSSSSSSSSSX--------xxxx------QQQQQQQQQ------------xX
xx----XXXXXX--------x---------------------xx----XXXXXXXXXXX-----------x--------XXXX---------------------------------xx---x--------------------------XX
x-----XXXXXX---------x-------------------xx---E-XXXXXXXXXXX------------x------SX-------------xxx------------xxxxx--xx-----x-------------------ExxxEXXX
X-----XXXXXX----------xxxxxxxxxxxxxxxxxxxx------XXXXXXXXXXX-----------X-xxxxxxxxxxxxxxxxxxxxxx--xxxxxxxxxxxxx----xxx-------xxxxxxxxxxxxxxxxxxxxx--xxxx
X-----XXXXXX----------XXXXXXXXXXXXXXXXXXXXXXXXXXXXXXXXXXXXX--XXXXXXXXXXXXXXXXXXXXXXXXXXXXXXXXX--XXXXXXXXXXXXX----XXX------XXXXXXXXXXXXXXXXXXXXXX--XXXX