------------------------------------------------------------------------------------------------------------------------------------------------------
------------------------------------------------------------------------------------------------------------------------------------------------------
------------------------------------------------------------------------------------------------------------------------------------------------------
------------------------------------------------------------------------------------------------------------------------------------------------------
-------------------------------------------------------xx-----------------XXX-------------------------------------------------------------------------
XXX-----------------------------x---------------------xx-x------------------------E-------------------------SSSSS-----------------------XX------------
---------------------------------x-------------------xx---x--------------------------------------------------------X--X-----------E-----XX------------
----------------------------------x-----------------xx-----x-------------------------------------------------------X--X----------<>-----XX------------
-----------------------------------x---------------xxX------x----xxxx---------SSSS-SS----------------------------X-XE-X----------[]-----XX------------
--------------------xxx-------------x-------S?S---xxEX---S---x--xx------------------------------------xxx----EXXXX-XQQX----------XX-----XX------------
--------------------xB-x-------------x-----------xxXXX--------xxx----xxxxxxxxx-----------------------xxX-x------------------------------XX------------
xxx-----xxx--------xxb--x-------------x---------xxXXXX---------x-----XXXEXXXX-x------xxxx----------Exx-X--x------------------xxx----B-x-x----xxx----xx
x--xxxxxxE-xxxxxxxxx-BEE-xxxxxxxx----X-xxxxxxxxxxXXXXX----EE---B-----XX--------xxxxxxx---xxxxxxxxxxxx--X---xxxxxxxxxxxxxxxxxxx--xxxxxxx--xxxxx--xxxxxE
X--XXXXXXXXXXXXXXXXXXXXXXXXXXXXXXXXXXXXXXXXXXXXXXXXXXXXXXXXXXXXX-----XX-------XXXXXXXX---XXXXXXXXXXXX--XXXXXXXXXXXXXXXXXXXXXXX--XXXXXXXxXXXXXX--XXXXXX