------------------------------------------------------------------------------------------------------------------------------------------------------
------------------------------------------------------------------------------------------------------------------------------------------------------
------------------------------------------------------------------------------------------------------------------------------------------------------
------------------------------------------------------------------------------------------------------------------------------------------------------
--------------------------------------------------------------------------------------xxxx------------------------------------------------------------
-------SSSSSSSS----------------------------------------------------------------------xxXX-x---------------------------------------------SSSSSSS-------
--------------------------xxx-------------------------------------------------------xxXXX--x----------------------------------------------------------
-----------------------xxxx-ox-----------------------------------------------------xxXXXX---x---------------xxxxx-------------------------------------
--------E---E---------xxXSS---x---ooo----------------------------xx---------------xxXXXXX----x-----------xxxx-<>-x-----------------------E--E--------x
x-----SSSSSSSSS------xxXXX-----xxx---------E--------------xxxx--xx-x-------------xxXXXXXX--S--x---------xxQQ?-[]--x---------------------SSSSSSS-----xx
-xxx----------------xxXXXX-----<>-x------------E-QQ?-----xx---xxx---x-----------xxXXXXXXX------x-------xx-----[]---x--------------Q?Q--------------xxX
-<>-x------xxx-----xxXXXXX-----[]--x--------------------xx-----x-----xx--------xxXXXXXXXX-------x-----xx------[]----x----------------------xxx----xxXX
-[]--xxxxxxx--xxxxxxXXXXXX-----[]---xxxxxxxxxxxxxxxxxxxxxX-----X-----X-xxxxxxxxxXXXXXXXXX--------xxxxxx--X----[]-----xxxxxxxxxxxxxxxxxxxxxxx--xxxxxXXX
XXXXXXXXXXXX--XXXXXXXXXXX-XXXXXXXXXXXXXXXXXXXXXXXXXXXXXXXX-----X-----XXXXXXXXXXXXXXXXXXXXXXXXXXXXXXXXXXXXXXXXXXXXXXXXXXXXXXXXXXXXXXXXXXXXXXX--XXXXXXXX