------------------------------------------------------------------------------------------------------------------------------------------------------
------------------------------------------------------------------------------------------------------------------------------------------------------
------------------------------------------------------------------------------------------------------------------------------------------------------
------------------------------------------------------------------------------------------------------------------------------------------------------
------------------------------------------------------------------------------------------------------------------------------------------------------
-----------------SSSS--XSX-------------------S------------------------------------QQQ-----------------------------------------------------------------
--------------------------------------------------------oooo----------oooo----------------------------------------------------------------------------
B-----------------------------------------------------------------------------------------------------------------------------------------------------
b-----------------E-----------------------------------------------xxxx--------------------------------------------------------------------------------
ooxx----xxxxx---SSSSSSSSSSS----------------QQQQ------xxx---------xx<>-x---------QQ?----------------------xxx------------------------------------------
-------xx-<>-x--------------------------------------xxX-x-------xx-[]--x---------------------------------xB-x---------------E--------B---?QQ----------
------xx--[]--x-----------------xxxx---------------xx-X--x-----xx--[]---x---------xxx------xxx----------xxb--x-----------------------b----------------
xxxxxxx---[]---xxxxxxxxxxxxxxxxxx---xxxxxxxxxxxxxxxx--X---xxxxxx---[]----xxxxxxxxxx--xxxxxxxE-xxxxxxxxxxx-BEE-xxxxxxxxxxxxxxxxxxxxxxxxxxxxxxxxxxxxxxxx
XXXXXXX--XXXXXXXXXXXXXXXXXXXXXXXX---XXXXXXXXXXXXXXXXXXXXXXXXXXXXXXXXXXXXXXXXXXXXXXX--XXXXXXXXXXXXXXXXXXXXXXXXXXXXXXXXXXXXXXXXXXXXXXXXXXXXXXXXXXXXXXXXX