------------------------------------------------------------------------------------------------------------------------------------------------------
------------------------------------------------------------------------------------------------------------------------------------------------------
SSSSSSSSSSSSSSSSSSSSSSSSSSSSSSSSSSSSSSSSSSSSSSSSSSSSSSSSSSSS-SS---------------------------------------------------------------------------------------
SS-----------SSSSSSSSSSS----SSSS------SSSS------------------------------------------------------------------------------------------------------------
SS-----------SSSSSSSSSSS----SSSS--E---SSSS------------------------------------------------------------------------------------------------------------
SS-----------SSSSSSSSSSS-----S----SS---------QQ-------------XXX----------XXXXXXXXXXXXXXXX-----------------------------------------------E-------------
-----------------------------S----SS------------------------------------------------------------------------------------------------E-----------------
-xxx-------------------------S----SS----------------------------------------------------------------------------------------------------------------xx
xx--x--------xxxxxxxx--------So??-SS---E-----------------------------------------------------------------------------------------------------------xx-
SS---x------xx-SSSSSSx-------SSS--SS--SSSS------------------------xx--------------------------------------xx--------------------------------------xx--
------xxx--xx---------x--------------EE--------------------------xx-x------------------------------------xB-x----------------E---------------E---xx---
------<>-xxx-----------x-----------------xxxx------xxxx---------xx---x--------xxx-xxx-xxx-----xxx-------xxb--x----------------------------------xx----
o---E-[]--x------------Exxxxxxxxxxxxxxxxxx---xxxxxxxB--xxxxxxxxxx-----xxxxxxxxxS-xx--xx--xxxxxxE-xxxxxxxx-BEE-xxxxxxxxxxxxxxxxxxxxxxxxxxxxxxxxxxxX----
XXXXXXXXXXX---XXXXXXXXXXXXXXXXXXXXXXXXXXXX---XXXXXXXX--XXXXXXXXXX-----XXXXXXXXX--XX--XX--XXXXXXXXXXXXXXXXXXXXXXXXXXXXXXXXXXXXXXXXXXXXXXXXXXXXXXXXX----