------------------------------------------------------------------------------------------------------------------------------------------------------
------------------------------------------------------------------------------------------------------------------------------------------------------
------------------------------------------------------------------------------------------------------------------------------------------------------
------------------------------------------------------------------------------------------------------------------------------------------------------
------------------------------------------------------------------------------------------------------------------------------------------------------
-------------------------------------------------------------------------xxxx------------------XX--------------------------------------xxxx-----------
-------------------------------------------------------------------------x<>-x-----------------[]--------------------------------------x<>-x----------
-------------------------------------------------------------------------x[]--x----------------[]--------------------------------------x[]--x---------
E----X-------------------------------------------------------------E----xx[]---x----xxxx-------[]--------------------------------E----xx[]---x----xxxx
>---XX-----------------------------------ooo---------------------------xxS[]----x--xx---xx-----<>SSSSSS------------------------------xxS[]----x--xx---
----XX---------------------------------------------------------oo-----xx--[]-----xxx----X-x---------------------------E------oo-----xx--[]-----xxx----
SSSSXX-------xxx---xxx-------xxxx----------xxx----xxxx---------oo----xx---[]------x-----XX-xx---Exxx-------------------------oo----xx---[]------x-----
xxxxxxxxxxxxxx--xxxx--xxxxxxxxEE-xxxxxxxxxxx--xxxxxEE-xxxxxxxxxxxxxxxx----[]------B-----XXXX-xxxxxE-xxxxxxxxxxxxxxxxxxxxxxxxxxxxxxxx----[]------B-----
XXXXXXXXXXXXXX--XXXX--XXXXXXXXXXXXXXXXXXXXXX--XXXXXXXXXXXXXXXXXXXXXXXXXXXXXXXXXXXXX-----XXXXXXXXX<>XXXXXXXXXXXXXXXXXXXXXXXXXXXXXXXXXXXXXXXXXXXXXX-----