---------------------------------------------------------------------------------------------------------------xxx--------xxx-------------------------
--------------------------------------------------------------------------------------------------------------xx--x------xx--x------------------------
------------------------------------------------------------------------------------SSS----------------------xx----x----xx----x-----------------------
------------------------------------------------------------------------------------[]----------------------xx------x--xx------x-xxx------------------
------------------------------------------------------------------------------------[]--------------------xxx--------xxx--------xx--x-----------------
--------------------------------------------------------xxxxS-------SSS-------------[]-------------------xxXX--------XXX--------XX---x----------------
-------------------------------------------------------xx--xxx----------------------[]------------------xxXXX--------XXX--------XX----x---------------
------------------------------------------------------xx------x-xxx-----------------[]-----------------xxXXXX--------XXX--------XX-----x--------------
------------------------------ooo--------------------xx----E-EExx--xx---------------[]-------E--------xxXXXXX--------XXX--------XX------x-------------
---xxxx-----------------------ooo-------------------xxX--------XX-XX-x--------------[]------<>-------xxXXXXXXS-------XXX--------XX-------x------------
--xx-X-x--------------------------------------E----xxXXX-------XX-XX--x-------------<>--------------xxXXXXXXX--------XXX--------XX--------x-----xxx---
Exx--X--x----------xxxx----------------------<>---xxXXXX-------XX-XXX--x---------------------------xxXXXXXXXX--------XXX--------XX---------x---xxB-x--
xx---X---xxxxxxxxxxxEE-xxxxxxxxxxxxxxxxxxxxxxxxxxxxXXXX--------X--XXX--ExxxxxxxxxxxxxxxxxxxxxxxxxxxxXXXXXXXXX--------XXX--------XX----------xxxx-b--xx
XX---XXXXXXXXXXXXXXXXXXXXXXXXXXXXXXEEXEXXXXXXXXXXXXXXXX--------X--XXXXXXXXXXXXXXXXXXXXXXXXEXXXXXXXXXXXXXXXXXXXX------XXX--------XXXXXXXXX---XXXXXXXXXX