------------------------------------------------------------------------------------------------------------------------------------------------------
------------------------------------------------------------------------------------------------------------------------------------xxxx--------------
-----------------------------------------------------------------------------------------------------------------------------------xx---x-------------
----------------------------------------------------------------------------------------------------------------------------------xx-----x------------
---------------------------------------------------------------------------------------------------------------------------------xx-------x-----------
--------------------------------------------------------------------------------------------------------------------------xxxxxxxx------E--xxxxxxxxxxx
------------------E-------------------------------XX---------------------------------------------------------------------xx?QQQQQQ---------SSSSSSSSSSS
-----------------<>---------------------------xxx-XX--------------------------------------------------------<>----------xx----------------------------
-----------------[]--------------------------xxXx-XX--------------------------------------------------------[]---------xx-----------------------------
xx--------SSS----XX-------------------------xxXX--XX----------------------X-------------------------ooo-----XX---xxxxxxx--------------------------E---
B-x--------------------xxxx----------E----ExxXXX-xXX----------------------X-------------------------------------xx--QQQ?--xS---------------------<>---
b--x----------------B-xx<>-x---B----------xxXXXX--x--------xxx--------SSSSX---------------xxx---------xxx------xx--------------------------------[]---
?-E-xxxxxxxxxxxxxxxxxxx-[]--xxxxxxxxxxxxxxxXXXXX---xxxxxxxxxX-xxxxxxxxxxxxxxxxxxxxxxxxxxxxxE-xxxxxxxxxx--xxxxxxx---------------------------------[]---
XXXXXXXXXXXXXXXXXXXXXXXXXXXXXXXXXXXXXXXXXXXXXXXXXXXXXXXXXXXXXXXXXXXXXXXXXXXXXXXXXXXXXXXXXXXXXXXXXXXXXXX--XXXXXXX------------EE-------------------[]---