------------------------------------------------------------------------------------------------------------------------------------------------------
------------------------------------------------------------------------------------------------------------------------------------------------------
------------------------------------------------------------------------------------------------------------------------------------------------------
------------------------------------------------------------------------------------------------------------------------------------------------------
--------xxxxxxE--------------------------------------------------------------------------------------E------------------------------------------------
-------xx?SES-x-----------------------------------------------XX---------------------------------SSSSSS----S------------------------------------------
-------x--->---x----------------------------------------------[]--------------------------------------------------------------------------------------
--xxxxxx---]----x---------------------------------------------[]--------------------------------------------------------------------------------------
-xx---xE---]-----xxx-------------------SSSSSSX--?-------------[]----------------------------------E---------------------------------------------------
xx----<>---]-----<>-x-----------------------------------x-----<>SSSSSS--------------------xxxx---SSSSSS---xxxx---------xxx----------------------------
x-----[]--<>-----[]--x-----------------------------------x-------------------------------xx<>-x----------xx<>-x-------xxX-x---------------------------
>-----[]--[]-----[]---x------xxxxx---------------xxx------xx---Exxx---------SS--------B-xx-[]--x--------xx-[]--x-----xx-X--x-------Exxx-------xxxx----
]--E--[]--[]-----[]----xxxxxxx----xxxxxxxxxxxxxxxx--xxxxxXX-xxxxxE-xxxxxxxxxxxxxxxxxxxxxx--[]---xxxxxxxxx--[]---xxxxxx--X---xxxxxxxxx--xxxxxxxxEE-xxxx
XXXXXXXXXXXXX----XXXXXXXXXXXXX---XXXXXXXXXXXXXXXXX--XXXXXXXXXXXX<>XXXXXXXXXXXXXXXXXXXXXXXXXXXXXXXXXXXXXXXXXXXXXXXXXXXXXXXXXXXXXXXXXXX--XXXXXXXXXXXXXXX