------------------------------------------------------------------------------------------------------------------------------------------------------
----------------------------------------xxxxxxxxxxxxxxxxxxxxxxxxxxxxxxxxxxxxxxxxxxxxxxxxxxxxxxxxxxxxxxxxxxxxxxxx--------------xxxxxxx-----------------
SSSSSSSSSSSSSSSSSSSSSSSSSSSSSSS--------xxSSSSSSSSSSSSSSSSSSSSSSSSSSSSSSSSSSSSSSSSSSSSSSSSSSSSSSSSSSSSSSSSSSSSSS-x-----SSSS---xxSSSSSSx---SSSSSSSSSSSSS
SSSSSSSSSSSSSSSSSSSSSS----------------xx-------------------------------------------------------------------------x----------xx--------x--SSSSSSSSSS---
SSSSSSSSSSSSSSSSSSSSSS-----------XXX-xx---------------------------------------------------------------------------x----?---xx----------x-SSSSSSSSSS---
SSSSSSSSSSSSSSSSSSSSSS--QQ------xxxx-xSSS------------E------------------------E------------------------------------x--S??-xx------------xSSSSSSSSSS---
-------------------------------xx---xx--------------<>-----------------------<>-------------------------------------x----xxXXX-----------x--S---------
xxx------------------xxx-xxx--xx-----xS-------------[]-----------------------[]--------------------------------------x--xx----------------x-S---------
x?-xxxxxxxxxxxxxxxxxxx--xx--xxx------S-S------------[]-------S---------------[]-------S--------------------E----------xxx------------------xSxxxxxxx--
???SSSSSSSSSSSSSSSSSSS--QQ--QQQ---------S------E--SS[]SS---E----E-------E--SS[]SS---E----E----------------<>------XXX-SSSS------------------xx-<><>-x-
---SSSSSSSSSSSSSSSSSSS------------------------<>----[]----<>---<>------<>----[]----<>---<>-------------XX-[]--XXX------------------E--------XX-[][]--x
---SSSSSSSSSSSSSSSSSSS------------------------[]----[]----[]---[]------[]----[]----[]---[]------------XXX-[]--XXX-----------------<>-------XXX-[][]---
oooSSSSSSSSSSSSSSSSSSS------------------------[]-E--[]----[]---[]------[]-E--[]----[]---[]--------E-E-XXX-[]--XXX-----------------[]----E--XXX-[][]---
XXXXXXXXXXXXXXXXXXXXXXXXXXXXXXX------XXXXXXXXXXXXXXXXXXXXXXXXXXXXXXXXXXXXXXXXXXXXXXXXXXXXXXXXXXXXXXXXXXX--XX--XX------XXXX------XXXXXXXXXXXXXX-XXXXXXE