------------------------------------------------------------------------------------------------------------------------------------------------------
------------------------------------------------------------------------------------------------------------------------------------------------------
------------------------------------------------------------------------------------------------------------------------------------------------------
------------------------------------------------------------------------------------------------------------------------------------------------------
---------------------------------------------------------------------------------------------------------------E--------------------------------------
---------------------------------------------------------SSSSSSS---------------E------E------------------------S--------------xxx---------------------
----------------------------------------------------------------------------E------------------------------------------------xx--xx-------------------
------o-----------------------------------------------------------------xxxxxxxxxxxxxxx------------------------?------------xx---X-x-----oooo-----oooo
----------------------------------------------B-----------E--E---------xxXSSSSSSSSSSSS-x-------------xxxx------------------xx-E--X--x----oooo-----oooo
----SSS---X-----------------------------------b----------SSSSSSS------xxXX--------------x--------QQ-xx-X-x----xxx---------xx--X--X---x----------------
-------EE-X---------------------------?-B--B------?QQ----------------xxXXX----oooooo-----x---------xx--X--x--xxX-x-------xxE--X--X----xxxxxxxxxxxxxxxx
----SSSSSSX----------------xxx----------b--b----------------xxx-----xxXXXX----------------xxxx----xx---X---xxx-X--x-----xx-X--X--X----XXXXXXXXXEXXXXXX
xxxxxxxxxxxxxxxxxxxxxxxxxxxxE-xxxxxxxxxxxxxxxxxxxxxxxxxxxxxxx--xxxxxxXXXXX----oooooo-------x--xxxxx----X----x--X---xxxxxx--X--X--X----X---------------
XXXXXXXXXXXXXXXXXXXXXXXXXXXXXXXXXXXXXXXXXXXXXXXXXXXXXXXXXXXXX--XXXXXXXXXXXXXXXXXXXXXXX-----X--XXXXX--XXXXXXXXXXXX-XXXXXXX--X--X--X----X---------------