------------------------------------------------------------------------------------------------------------------------------------------------------
------------------------------------------------------------------------------------------------------------------------------------------------------
------------------------------------------------------------------------------------------------------------------------------------------------------
------------------------------------------------------------------------------------------------------------------------------------------------------
------------------------------------E-----------------------------------------------------------------------------------------------------------------
--------------------------------SSSSSS----S--------------------------------------?SS---------------------------------------SSSSSSS--------------------
------------------------------------------------------------------------------------------------------------------------------------------------------
-------------B----------------------------------------------------------------------------------------------------------------------------------------
-------------b-------------------E-------------------------xxxxx------------------------------------------------------------E--E------------E---------
-----------SSXSS-------xxxxx---SSSSSSS---xxxx------------xxx----x----------------------------QQQQ--------------------------SSSSSSS----E----<>---------
B---?QQ---------------xx-<>-x-----------xx<>-x----------xx<>-----xx-----------E---B-----------------B-----E---B-----QQQ--------------<>---------------
b----------------B---xx--[]--x---------xx-[]--x------B-xx-[]----<>-x----B---------b-------B--E------b---------b---------------xxx-----------------xxxx
xxxxxxxxxxxxxxxxxxxxxx---[]---xxxxxxxxxx--[]---xxxxxxxxx--[]-E--[]--xxxxxxxxxxxxxxxxxxxxxxxxxxxxxxxxxxxxxxxxxxxxxxxxxxxxxxxxxxx--xxxxxxxxxxxxxxxxxx---
XXXXXXXXXXXXXXXXXXXXXX--XXXXXXXXXXXXXXXXXXXXXXXXXXXXXXXXXXXXXXXXXXXXXXXXXXXXXXXXXXXXXXXXXXXXXXXXXXXXXXXXXXXXXXXXXXXXXXXXXXXXXXX--XXXXXXXXXXXXXXXXXX---