------------------------------------------------------------------------------------------------------------------------------------------------------
------------------------------------------------------------------------------------------------------------------------------------------------------
E-----------------------------------------------------------------------------------------------------------------------------------------------------
>------------------------xxx--------------------------------------------------------------------------------------------------------------xxx---------
]--------------xxxx----xxx--x-----------------------------------------------------------------------------------------------------------xxx--x--------
]S------------xx---x--xxXS---x----------------------------------------------------------------------------xxxE-----oo------------------xxXX---x-------
X------------xx-----xxxEX-----x-----------------------------------------------------------------------xxxxx--x-------------XXX--------xx-XX----x------
------------xx-------xXXX------x---------------------------------------------------------------------xxXXXX---x---xxx----------------xxXXXX-----x-----
----------xxx--------XXXXS------x--------------------B-------------------------------SSSSS---------xxx---------xxxx--xxxxx----------xx-XXXX------x----
---------xx<>-------XXXXX--------x---------B---------b--------------------------------------------xx<>---------XXXX--XXXX-x--------xxXXXXXX-------x---
--------xx-[]------XXXXXX---------x--------b--?-B-o------?QQ-------------------------------------xx-[]---------------------x------xx-XXXXXX--------x--
x------xx--[]-----XXXXXXX----------x-------B----b------------------------xxx----xxxxx----xxxx---xx--[]----------------------x----xx--XXXXXX---------x-
-xxxxxxx---[]----XXXXXXXX---------X-xxxxxxxxxxxxxxxxxxxxxxxxxxxxxxxxxxxxxx--xxxxx----xxxxx---xxxx---[]-------oo--------------xxxxx---XXXXXX--------X-x
XXXXXXXXXXXXXXX-XXXXXXXXXXXXXXXXX-XXXXXXXXXXXXXXXXXXXXXXXXXXXXXXXXXXXXXXXX--XXXXX--X-XXXXX---XXXXXXXXXXXXXXSSXX-------------XXXXXXXXXXXXXXXXXXXXXXXXXX