------------------------------------------------------------------------------------------------------------------------------------------------------
--------------------------xxxxxx--------------------------------------------------------------xx------------------------------------------------------
--------------------------xXXXX-x------------SSSSSSSSSSSSSSSSSSSSSSSSSSSSSSSSSSSSS-----------xx-xxx---------------------------------------------SSSSSS
-------------------------xxXXX---x-------------[]---[]--------------------------------------xx--XX-x--------------------------------------------[]----
------------------------xx-XXX----x------------[]---[]-------E-----------------------------xx---XX--x-------------------------xxxx--------------[]----
------------------------xS-XXX-----x-----------[]---[]---QQQQQQ-----------------E----------xS---XX---x-----------------------xxXX-x-------------[>----
------------------------x--XXX------x----------<>---[]-------------------------<>----------x----XX----x-----------------------XXX--x------------------
-----------------------xx--XXX-------x--------------[]-------------------------[]------xxxxx----XX-----x----------------------XXX---x-----------------
--xxxx----------------xxS--XXX--------x-------------[]--xxxxxxxxxxxxx-xxx------[]----xxx---x----XX------x-xxx-----------------XXX----x---------------x
-xx<>-x-------------x-x----XXX---------x------------<]-xxSSSSSSSSSSS-xx--x-----XXX--xx<>---SS---XX-------xx--x----------------XXX-----x------S?S----xx
xx-[]--x-------------xx----XXX----------x------------>xx-SSSSSSSSSSS-SS---x--------xx-[]--------XX-------<>---x---------------XXX------x-----------xx-
x--[]---x---xxx-----xx---E-XXX-----------x----xxx----xx--SSSSSSSSSSSSSS----x------xx--[]--------XX-------[]----x--------------XXX-------x---------xx--
E--[]----xxxx--xxxxxx------XXX----------X-xxxxx--xxxxx---SSSSSSSSSSSSSS-----xxxxxxx---[]--------XX-------[]-E---xxxxxxxxxxxxxxXXX-------Xxxxxxxxxxx---
XXXXXXXXXXXXX--XXXXXXXXXXXXXXXXXXXXXXXXXXXXXXXX--XXXXXE--XXXXXXXXXXXXXXXXXXXXXXXXXXXXXXXXXXXXXXXXXXXXXXXXXXXXXXXXXXXXXXXXXXXXXXXXXXXXXXXXXXXXXXXXXX---