xxx-----------------xxx----------xxx-------------------------------------------------------------------------------xxxxx------------------------------
x--x-------xx------xx--x--------xx--x------xxxx-------------------------------------------------------------------xx----x-----------------------------
S---x-----xx-x----xx----x------xx----x----xx---x-----------------------------------------------------------------xx------x----------------------------
-----x---xx---x--xx------x----xx------x--xx-----x------xxx---xxx------------------------------------------------xx--------x-xxx-----------------------
------x-xx-----xxx--------xxxxx--------xxx-------x-xxxxx--xxxx--x---------------------------------------------xxx----------xx--x----------------------
-------xx------XXX--------XXXXX--------XXX--------xx--XX--XXXX---x-------------------------------------------xxXX----------XX---x---------------------
]------XX-----------------------------------------XX--------------x-----------------------------------------xxXXX----------XX----x-------------------x
]---------------------oo-------------------------------------------x---------------------------------------xxXXXX----------XX-----x-----------------xx
]---------------------SS--------------------------------------------x---------------E---------------------xxXXXXX----------XX------x---------------xxX
]--------------------------------------------XX----------------------x------------xxxx-------------------xxXXXXXX----------XX-------x-------S?S---xxEX
]---------------------------------------------------------------------x----------xx<>-x--------X--------xxXXXXXXXx]--------XX--------x-----------xxXXX
]----------------------------------------------------------------------x-------Qxx-[]--x---------------xxXXXXXXXXB]--------XX---------x---------xxXXXX
]-------------o---o---------------------------------------------------X-xxxxxxxxx--[]---xxxxxxxxxxxxxxxxXXXXXXXXXb]--------XX--------X-xxxxxxxxxxXXXXX
X-------------X---X---------------XXX---------------------XXXXXXX-----XXXXXXXXXXXXXXXXXXXXXXXXXXXXXXXXXXXXXXXXXXXXXXXX-----XXXXXXXXXXXXXXXXXXXXXXXXXXX