------------------------------------------------------------------------------------------------------------------------------------------------------
------------------------------------------------------------------------------------------------------------------------------------------------------
------------------------------------------------------------------------------------------------------------------------------------------------------
------------------------------------------------------------------------------------------------------------------------------------------------------
-------------------------------------------------------------------------xxxxx------------------------------------------------------------------------
SSSX--------------------------------------------------------------------xxXXX-x-------------------------------------------------------------------SSSS
-----------X--EX-----------------------------------------------E-------xxXEXX--x--------------------------------------------xxx-----------------------
-----------X---X------------------------------------------------------xxEXXXX---x---------------------------------------xxxxx--x----------------------
-----X---X-X---X--------X-EE----X-------------ooo--------------------xxEXXXXX----x----------E--------------------------xxXSSS---x------------------E--
-----X-SSX-XSS?X--------XSSSSSSSX-----------------------------------xxXXXXXXX-----x-----------xxxx---------------------x-X-------x--------------------
-------------------------------------------------------E-----------xxXXXXXXXX------x---------xx<>-x-------------------xx-X--------x-------xxx---------
xxx-----------------xxx-------------------------------------------xxXXXXXXXXX-------x-------xx-[]--x-----------------xx--X--------X------xxB-x--------
x--xxxxxxxxxxxxxxxxxx--xxxxxxxxxxxxxxxxxxxxxxxxxxxxxxxxxxxxxxxxxxxxXXXXXXXXXX-------Xxxxxxxxx--[]---xxxxxxxxxxxxxxxxxxE-EX--------Xxxxxxxx-b--xxxxxxxx
X--XXXXXXXXXXXXXXXXXX--XXXXXXXXXXXXEEXEXXXXXXXXXXXXXXXXXXXXXXXXXXXXXXXXXXXXXXXXXXXXXXXXXXXXXXXXXXXXXXXXXXXXXXXXXXXXXXXXXXXXXXXX---XXXXXXXXXXXXXXXXXXXX