------------------------------------------------------------------------------------xxx---------------------------------------------------------------
---------------------------------------------------------------------xxxxxxxxxxxxxxxx--x--------------------------------------------------------------
---------------------------------------------------------------------xXXXXXXXXXXXXXXX---x-------------------------------------------------------------
--------------------------------xxx---------------------------------xxXXXXXXXXXXXXXXX----x------------------------------------------------------------
------------------------------xxx--x--------------E----------------xx-XXXXXXXXXXXXXXX-----x-----------------------xxxxxxx-----------------------------
-----------------------------xxXX---x-----E-SSSSS------------------xS-XXXXXXXXXXXXXXX------x---------------------xx-SSSS-x----------------------------
----------------------------xxXXX----x-E---------------------------x--XXXXXXXXXXXXXXX-------x-------------------xx--------x---------------------------
------------------------xxxxxXXXX-----x---------------------------xx--XXXXXXXXXXXXXXX--------x-----------------xx----------x--------------------------
-----------------------xx--xXXXXX------x-------------------------xxS--XXXXXXXXXXXXXXX---------x---------------xxX-----------x-------------------------
----------------------xx---XXXXXX-------x----SSS-----------------x----XXXXXXXXXXXXXXX----------x-------S?S---xxEX---S-----X--x-----------------xx-----
---------------------xx----XXXXXX--------x----------------------xx----XXXXXXXXXXXXXXX-----------x-----------xxXXX---------X---x---------------xB-x----
xx-----------xxxxxx-xx-----XXXXXX---------x--------------------xx---E-XXXXXXXXXXXXXXX------------x---------xxXXXX---------XX---x-------------xxb--x---
E-xxxxxxxxxxxx--EE-xxX-----XXXXXX----------xxxxxxxxxxxxxxxxxxxxx------XXXXXXXXXXXXXXX-----------X-xxxxxxxxxxXXXXX----EE---XX---Exxxxxxxxxxxxxx-BEE-xxx
XXXXXXXXXXXXXX--XXXXXX-----XXXXXX----------XXXXXXXXXXXXXXXXXXXXXXXXXXXXXXXXXXXXXXXXXX--XXXXXXXXXXXXXXXXXXXXXXXXXXXXXXXXXXXXXXXXXXXXXXXXXXXXXXXXXXXXXXX