-------------------------------------------------------------------------------------xxx---------xxx-----------------------------xxx---------xxx------
---------------------------------------------------------------------------xxx------xx--x-------xx--x------xxx---------xxx------xx--x-------xx--x-----
------------------------------------------------------------------xxx-----xx--x----xx----x-----xx----x----xx--xx------xx--x----xx----x-----xx----x---x
-----------------------------------------------------------------xx--x---xx----x--xx------x---xx------x--xx----xxx---xx----x--xx------x---xx------x-xx
-----XXX----ooo----------------E--------------------------xxx---xx----x-xx------xxx--------xxxx--------xxx--------xxxx------xxx--------xxxx--------xx-
-----------------------SSSSSSS-----------S----------SS---xx--x-xx------xx-------XXX--------XXXX--------XXX---------XXX------XXX--------XXXX--------XX-
-----------------------------------------S--------------xx-E--xx-------XX-----------------------------------------------------------------------------
-------------------------------------------------------xx-----XX-----------------------oo------------------------------------------oo-----------------
-----------------------------------------SSS--------xxxx-------------------------------SS------------------------------------------SS-----------------
-----------------------------------------SSS-------xx-XX-------o------------------------------------------------?-------------------------------------
-------------------------------------X---SSS------xx-----------o--XX----------------------------------------------------------------------------------
------------------------------------------SSx----xx------------------------------------------------------------------------------------------------o--
EE-------------------------E--------------SS-xxxxx-----------------------------o---o------------------------XXX------------o---o-------------------ooo
XXXXX---------XXXXXXXXXXXXXXXXXXXXXXXXXXXXXXXXXXXX-----------------------------X---X--------------XXX----------------------X---X-------------------XXX