------------------------------------------------------------------------------------------------------------------------------------------------------
------------------------------------------------------------------------------------------------------------------------------------------------------
------------------------------------------------------------------------------------------------------------------------------------------------------
xx----------------------------------------------------------------------------------------------------------------------------------------------------
--x---------------------------------------------------------------------------------------------------------------------------------------------------
---x-----------------------x-------SSSSSSS----------XXXXXXXXXXXXXXX------------------------------------------------------------------------------XXX--
----x-----------------------x-------------------------------------------------------------------------------------------------------------------------
-----x-----------------------xxxx--------xxx----------------------------------------------------------------------------------------------------------
------x-----------------------xB-xxxxxxxxx--x---------------------------------------------------------------------------------------------------------
-------x----------xx----------XXXXESSSSSSS---x--------------------------------------xx-------------------------------------------------------QQQQQQQQQ
-E------x--------xB-x--------EXXXXX-----------x-------------------------------------xBx---------------XX----------------------------------------------
<>-------x------xxb--x-------XXXXXX------------x--------xxx-xxx-xxx-----xxx--------xxb-x-------------------xxx-------------Exxx-----------xxxx-----xxx
[]------X-xxxxxxx-BEE-xxxxxxXXXXXXX-----------B-xxxxxxxxx--xx--xx--xxxxxxE-xxxxxxxxx-BEExxxxxxxxxxxxxxxxxxxxE-xxxxxxxxxxxxxxx--xxxxxxxxxxxxEE-xxxxxxX-
XXXXXXX-XXXXXXXXXXXXXXXXXXXXXXXXXXXXXXXXXXXEXXXXXXXXXXXXX--XX--XX--XXXXXXXXXXXXXXXXXXXXXXXXXXXXXXXXXXXXXXXXXXXXXXXXXXXXXXXXXX--XXXXXXXXXXXXXXXXXXXXXQX