------------------------------------------------------------------------------------------------------------------------------------------------------
------------------------------------------------------------------------------------------------------------------------------------------------------
------------------------------------xx----------------------------------------------------------------------------------------------------------------
-----------------------------------xx-x---------------------------------------------------------------------------------------------------------------
----------------------------------xx---x--------------------------------------------------------------------------------------------------------------
--xxxx------------------------xxxxx-----x--------------S----------------------------------------------------------------------------------------------
-xx---x----------------------xxXSSS------x----------------------x-----xxx----------------xxxxx-----XX---------------xx--------------ES-------------E--
xx-----x--------------xxxxxxxxXXX---------x------------------------xxxx--xx-------------xxXSS-xo-------------------xB-x------S--------------------<>--
x-------x--------S---xx--x--xXXXS----------x---ooo----------------xxXSS-SQ-x-----------xxXXX---x------------------xxb---------------------QQ------[]--
>--------x----------xx---X-XXXXXX-----------xxx--------S---------xxXXX------x---------xxXXXX-SS-x----------------xxXXX-xS----------------------QQQQQQQ
]---------x--------xx----X-XXXXXX-SSS-------<>-x----------------xxXXXX-------x-------xxXXXXX-----x--------------xxXXXX--x-----xxx---------------------
]----------xxxxxxxxx-----X-XXXXXX-----------[]--x--------------xxXXXXX--------x-----xxXXXXXX--SSS-x-------xxxxxxxXXXXX---x---xxB-x---------xxxxx------
]---------XXXXXXXXXE-----X-XXXXXX-----------[]---xxxxxxxxxxxxxxxXXXXXX--SSSSS--xxxxxxXXXXXXX-------xxxxxxxx----xXXXXXX----xxxx-b--xxxxxxxxxxB---xxxxxx
X---------XX-------------X-XXXXXXXX---XXXXXXXXXXXXXXXXXXXXXXXXXXXXXXX-------XX-XXXXXXXXXXXX------XXXXXXXXXX---XXXXXXXXXXXXXXXXXXXXXXXXXXXXXXX--XXXXXEE