------------------------------------------------------------------------------------------------------------------------------------------------------
------------------------------------------------------------------------------------------------------------------------------------------------------
S----SSSSSSSSSSSSSSSSSSSSSSSSSSSSSSSSSSSSSSSSS---------------------xxx-----xxx------------------------------------------------------------------------
S----SSSSSS--SSS------------SSSSSSSS------------------------------xx--x---xx--x-------xxx----xxx------------------------------------------------------
S----SSSSSS--SSS------------SSSSSSSS--E---------xxxx-------xxx---xx----x-xx----x-xxxxxx--xxxxx--x------------------------------SSS---SSSS-------------
S--------SS---S-------------SSSSSSSS--QQ-------xx---x-----xx--x-xx------xx------xx---XX--XXXXX---x-----S----------XQQ?QQX-----------------------------
SS-------SS---S-------------------------------xx-----x---xx-E--xx-------XX------XX----------------x----S----------X-----X----------------------------x
SS-------SS---S--------------------xxx-xxx---xx-------x-xx-----XX----------------------------------x--------------X-----X------X--------------------xx
SS---ooooSS---S??-----------xxxxxxxx--xx--xxxx---------xx-------------------------------------------x--SSS--------XE-E--X------XEE------X-------xxxxx-
SSS--SSSSSS---S?-----------xx-SSSSSS--QQ--QQQQ--S-----XXXS------o------------------------------------x-SSS--------XQQ-QQX------XSSSSSSSSX------xx-XXX-
SSS-----------------------xx--SSSSSS----------------------------o--XX---------------------------------xSSS------------------------------------xx------
-SS--------------xxx-xxx-xx---SSSSSS--------------------------------------------------------------------SSx-------------E---------------xxxxxxx-------
xxxxxxxxxxxxxxxxxx--xx--xx--------SS------------------------------------------------------------------X-SS-xxxxxxxxxxxxxxxxxxxxxxxxxxxxxx---XXX-------
XXXXXXXXXXXXXXXXXX--XX--XX---XXXXXXXXXXXXXXXXX-------------------------------------------XXXXXXXX-----XXXXXXXXXXXXXXXXXXXXXXXXXXXXXXXXXXX-------------