------------------------------------------------------------------------------------------------------------------------------------------------------
------------------------------------------------------------------------------------------------------------------------------------------------------
------------------------------------------------------------------------------------------------------------------------------------------------------
------------------------------------------------------------------------------------------------------------------------------------------------------
-ooo--E-----------------------------------------------------------------------------------------------------------------------------------------------
SSSSSSSSSSSSS--------SSSSSSS------------------SSSSSSS---------------E------E------------------------------SSSSSx--------SSS---------------------------
-----------------------------------------------------------------E---------------------------------------S------x-------------------------------------
-------------------------------------------------------------xxxxxxxxxxxxxxx-----------E----------------SS-------x------------------------------------
xxxxxxxxxxx------------------------------------E--E---------xxXSSSSSSSSSSSS-x----------]---------------SSS------------------------------xxxxx---------
SSSSSSSSSS-x--------------SSS-----------------SSSSSSS------xxXX-----o--------x--------QQ-xxx----------SSSS----------------------------xxx----x--------
------------x-------xxx---------?-B----?QQ----------------xxXXX----oooooo-----x---------xxB-x-------------------SS------------------Exx<>-----xx------
-------------x-----xxB-x----------b--------------xxx-----xxXXXX----------S-----xxxx----xx-b--x-------xxx--------SSx-------------B---xx-[]----<>-x---B-
--E-----------xxxxxx-b--xxxxxxxxxxxxxxxxxxxxxxxxxx--xxxxxxXXXXX----ooooooS------x--xxxxx--BEE-xxxxxxxxB-xxxxxxxxSS-xxxxxxxxxxxxxxxxxx--[]-E--[]--xxxxx
XXXXXXXXXXX---XXXXXXXXXXXXXXXXXXXXXXXXXXXXXXXXXXXX--XXXXXXXXXXXXXXXXXXXXXXX-----X--XXXXX--XXXXXXXXXXXXXXXXXXXXXXXXXXXXXXXXXXXXXXXXXXXXXXXXXXXXXXXXXXXX