------------------------------------------------------------------------------------------------------------------------------------------------------
------------------------------------------------------------------------------------------------------------------------------------------------------
------------------------------------------------------------------------------------------------------------------------------------------------------
------------------------------------------------------------------------------------------------------------------------------------------------------
-------------------------------------------------------------------------------------------------xxxx-------------------------------------------------
----------------SSSSSSS--------------SS-----E---------------------------------------------------xx---x-------------------------------?--X-------------
x----------------------------------------------------------------------------------------------xx-E---x---------------------------------X-------------
-------------------------------------------------E-------------------------------------------xxx-------x--------------------------------X-------------
-xx--------------------------------?------------<>------------------------------------------xx-E-----B--x--------------------------XQE--X-------------
<>-x---------------xxx--------------------------[]-----------------------------------------xx------------x---oooooooooo-----------XX--QQX-------------
[]--x---xxx-------xxB-x--------------B----------[------------------------------x----------xx--------------x--oooooooooo-----------XX------------------
[]---x-xxB-x-----xx-b--x-------B-----b--------------xxxxx-------Exxx------------xxx------xx----------------xxxxxxxxxxxxxxxx-------XX----E-------xxxxxx
[]----xx-b--xxxxxx--BEE-xxxxxxxxxxxxxxxxxxxxxxxxxxxxx----xxxxxxxxx--xxxxxxxxxxxxEE-xxxxxxxX---------------XXXXXXXXXXXEXXXX-xxxxxxxxxxxxxxxxxxxxxx--XXX
XXXXXXXXXXXXXXXXXXXXXXXXXXXXXXXXXXXXXXXXXXXXXXXXXXXXX---XXXXXXXXXX--XXXXXXXXXXXXXXXXXXXXXXX---------------XX-------------XXXXXXXXXXXXXXXXXXXXXXXX-----