--------------------------------------------------------------------------------------------------------------------------oxx-------------------------
----------------xx-------------------------------------------------------------------------------------------xxxxxxxxxxxxxx--x------------------------
---------------xx-xxx----------------------------------------------------------------------------------------xXXXXXXXXXXXXX---x------------SSSSSSSSSSS
--------------xx--XX-x--------------------------------------------------------------------------------------xxXXXXXXXXXXXXX----x-------------[]---[]--
-------------xx---XX--x---------------------------------------------------------------------E--------------xx-XXXXXXXXXXXXX-----x------------[]---[]--
?-------xxx--xS---XX---x----------------------------------------------------------------SSS----------------xS-XXXXXXXXXXXXX------x-----------[]---[]--
-------xx--x-x----XX----x----------------------------------------------------------------------------------x--XXXXXXXXXXXXX-------x----------<>---[]--
------xx----xx----XX-----x--------------------------------------------------------------------------------xx--XXXXXXXXXXXXX--------x--------------[]--
-----xx------x----XX------x------------Q--?----------------E----E----------------------------------------xxS--XXXXXXXXXXXXX---------x-------------[]--
---xxx-------SS---XX-------x---------Q-------ESSS----E----<>---<>--------------------E--SSS--------------x----XXXXXXXXXXXXX----------x------------[]-x
--xx<>------------XX--------x----------E------------<>-----------------------------X<>------------------xx----XXXXXXXXXXXXX-----------x-----------<>xx
-xx-[]------------XX---------x--------------------------------------xxxxx------------------------------xx---E-XXXXXXXXXXXXX------------x----xxx----xx-
xx--[]E-----------XX--------X-xxxxxxxxxxxxxxxxxxxxxxxxxxxxxxxxxxxxxxx----xxxxxxxxxxxxxxxxxxxxxxxxxxxxxxx------XXXXXXXXXXXXX-----------X-xxxxx--xxxxx--
XXXXXXXXXXXXXXXXXXXXXXXXXXXXXXXXXXXXXXXXXXXXXXXXXXXXXXXXXXXXXXXXXXXXX---XXXXXXXXXXXXXXXXXXXXXXXXXXXXXXXXXXXXXXXXXXXXXXXXXXXo----XXXXX-XXXXXXX--XXXXXE-