------------------------------------------------------------------------------------------------------------------------------------------------------
------------------------------------------------------------------------------------------------------------------------------------------------------
-------------------------------------------------------------------------------------------------------------SSSSSSSSSSSSSSSSSSSSSSSSSSSSSSSSSSSSSSSS[
------------------------------------------------------------------------------------------------------------------------SSSSSSSSSSSSSSSSSSSSSSSS------
------------------------------------------------------------------------------------------------------------------------SSSSSSSSSSSSSSSSSSSSSSSS------
SQ-----------------------SSSQ--------------?---------SSSS--------SSS----SQQS--------------------------------------------SSSSSSSSSSSSSSSSSSSSSSSS--QQ--
------------------------------------------------------------------------------------------------------------------------------------------------------
------------------------------------------------------------------------------------------------xxx---------------------------xxx--------------xxx-xxx
--------------------------------------------------------------------------------xxxxxx--------xxx--xx-------------------xxxxxxx?-xxxxxxxxxxxxxxx--xx--
-QQQ------------------------S-----SS----Q--Q--Q--Q-----------------------SS----xxX--X-x------xxXX--X-x-----------------xx-SSSSS??SSSSSSSSSSSSSSS--QQ--
------------------------------------------------------------------------------xxXX--XX-x----xxXXX--XX-x---xxxx--------xx--SSSS---SSSSSSSSSSSSSS-------
---------xxxx------xxxxx---------------------------------xxxx----------------xxXXX--XXX-x--xxXXXX--XXX-x-xx<>-x--x-xxxx---SSSS---SSSSSSSSSSSSSS-------
xxxxxxxxxx---xxxxxxx----xxxxxxxxxxxxxxxxxxxxxxxxxxxxxxxxxx---xxxxxxxxxxxxxxxxxXXXX--XXXX-xxxXXXXX--XXXX-xx-[]--xx-xx----------oooSSSSSSSSSSSSSSx------
XXXXXXXXXX---XXXXXXX--X-XXXXXXXXXXXXXXXXXXXXXXXXXXXXXXXXXX---XXXXXXXXXXXXXXXXXXXXXXXXXXXXXXXXXXXX--XXXXXXXXXXXXX--XX-----XXXXXXXXXXXXXXXXXXXXXXXXXXXXX