------------------------------------------------------------------------------------------------------------------------------------------------------
------------------------------------------------------------------------------------------------------------------------------------------------------
---------------------------------------------------------------------------------------?--------------------------------------------------------------
------------------------------------------------------------------------------------------------------------------------------------------------------
-------------------------------------------------------E----------------------------------------------------------------------------------------------
---------------------------------------------------SSSSSS----S--------------------------------xxxxx-------SSSSSS----------XXXXXXXXXXXXXXXX-----------S
--------------EX-------------------------------------------------------------------------SS--xx----x--------------------------[]-------[]-------------
---------------X----------------------------------------------------------------------------xxX-----xxxx-------xxx------------[]-------[]-------------
-----------X---X--------X-EE----X------------E------E--------------------------------SS----xxXX------xB-xxxxxxxx--x-----------[]-------[]-----------xx
---------X-XSS?X--------XSSSSSSSX-----------<>-----SSSSSS---xxxx------------xxx-----------xxXXX------XXXXESSSSSS---x----------[]-------[]----------xx<
-E--QQQQQX-X-----------------------------------------------xx<>-x----------xxX-x--B------xxXXXX-----XXXXXX----------x---------<>-------<>---------xx-[
--------------------xxx-----------------------------------xx-[]--x------B-xx-X--x-b----xxxXXXXX----XXXXXXX-----------x--------xxx------xxx-------xx--[
xxxxxxxxxxxxxxxxxxxxx--xxxxxxxxxxxxxxxxxxxxxxxxxxxxxxxxxxxx--[]---xxxxxxxxx--X---xxxxxxx-XXXXXX---XXXXXXXX----------B-xxxxxxxxxE-xxxxxxxE-xxxxxxxx---[
XXXXXXXXXXXXXXXXXXXXX--XXXXXXXXXXXXEEXEXXXXXXXXXXXXXXXXXXXXXXXXXXXXXXXXXXXXXXXXXXXXXXXXX-XXXXXXXXXXXXXXXXXXXXXXXXEXXXXXXXXXXXXXX-XXXXXXXX-XXXEXXXXX-XX