--xxx-------------------------------------------------------------------------------------------------------------------------------------------------
-xx--x------------------------------------------------------------------------------------------------------------------------------------------------
xx----x------------------------------------SS---------------------------------------------------------------------------------------------------------
x------x---------------------xxx-----------[]---------------------------------------------------------------xxx---------------------------------------
E-------x-----------------xxxx--x----------[]-----------------------------------------------------xxxx----xxx--x--------------------------------------
>--------x---------------xx--X---x---------[]--------------E---------E-E-E-E------------S--------xx---x--xxXS---x-------------------------------------
]X--------x-------------xx--------x--------[]-------------<>------E---<><><>--------------------xx-----xxxEX-----x------------------------------------
]X---------x---------xxxxE---------x-------[]-------------[]----------[][][]-------------------xx-------xXXX------x-----------------------------------
]X----------x------xxx--<>----------x------[]---xxxx---Q--Q]-Q--xxx---QQQQQQ--------------xxxxxx--------XXXXS------x-----------------B----------------
]S-----------x----xx<>--[]-----------x-----<>--xx<<-x------QQ--xx--x-----------------Q--xxx---<>-------XXXXX--------x--------B-------b----------------
SS---------------xx-[]--[]------------x-------xx-[]--x--------xx----x-----------xxxx---xx<>---[]------XXXXXX---------x-------b--?-B------?QQ------E---
SS--------------xx--[]--[]-------------x----Exx--[]---x------xx------x---------xx<>-x-xx-[]---[]-----XXXXXXX----------x------B----b-------------------
SSx-----------xxx---[]--[]------------X-xxxxxx---[]----xxxxxxx--------xxxxxxxxxx-[]--xx--[]---[]----XXXXXXXX--?------X-xxxxxxxxxxxxxxxxxxxxxxxxxxxxxxx
XXXXXXXXXXXXXXXXXEXXXX--XXXXXXX-------XXXXXXXXXXXXXXXXXXXXXXXX--------XXXXXXXXXXXXXX-XXX-XX--XXXXX-XXXXXXXXXXXXXXXXX-XXXXXXXXXXXXXXXXXXXXXXXXXXXXXXXXX