-----------------------------------------------------------------------------------------------------------------------------------------------S------
---------------------------------------------xxxx----------------------------------------------------------------------------------------------S------
SSSSSSSSSSS-------------SSS--[]SSSSSSSSSSSSSSSSSSx------------SSSSSSSSSSSSSSSSSSSSSSSSSSSSSSSSSSSSSS-SS--------SSS---SSS-------------SSS--[]SSSSSSSSSS
-----------------------------[]SSSSSSSSSSSSSSSSSS-x-------------[]----[]-------------------------------xxx--------------------------------[]SSSSSSSSSS
-----------------------------[]SSSSSSSSSSSSSSSSSS--x------------[]----[]-------E---------------------xxx--x-------------------------------[]SSSSSSSSSS
------------xx--xxxxx--------[]SSSSSSSSSSSSSSSSSS---x-----------[]----[]---QQQQQQ--------xxxxxxxxxxxxx<>---x-------------xx--xxxxx--------[]SSSSSSSSSS
-----------xx-xxx----x-------[]SSSSSSSSSSSSSSSSSS----x----------<>----[]----------------xxSSSSSSSSSSSS[]----x-----------xx-xxx----x-------[]SSSSSSSSSS
----------xx--XXX-----x------[]SSSSSSSSSSSSSSSSSS-----x---------------[]---------------xx-SSSSSS------[]-----x---------xx--XXX-----x------[]SSSSSSSSSS
------xxxxx------------x------]SSSSSSSSSSSSSSSSXS------x--------------[]--xxxxxxxxxxxxxx--SSSSSS------[]------x----xxxxx------------x------]SSSSSSSSSS
-----xx-XXX-------------xxxxx-]SSSSSSSSSSSSSSSSSS-------x-------------[]-xxSSSSSSSSSSSSS--SSS-----X--S[]-------xxxxx-XXX-------------xxxxx-]SSSSSSSSSS
E---xx-----------SSS-S--SSSSSSSSSSSSSSSSSSSSSSSSS--------x------------<>xx-SSSSSSSSSSSSS----------X---[]-------SSSx-----------SSS-S--SSSSSSSSSSSSSSSSS
>--xx------------SSS-S--SSSSSSSSSSSSSSSSSSSSSSSSS---------x----xxx-----xx--SSSSSSSSSSSSS----------XX--[]-------SSS------------SSS-S--SSSSSSSSSSSSSSSSS
xxxxX------------SSS-S--SSSSSSSSSSSSSSSSSSSSSSSSS--------X-xxxxx--xxxxxx---SSSSSSSSSSSSS--------E-XX--[]----------------------SSS-S--SSSSSSSSSSSSSSSSS
XXXXX---------XXXSSS-S--XXXXXXXXXXXXXXXXXXXXXXXXXXXXXXXXXXXXXXXX--XXXXXXE--XXXXXXXXXXXXXXXXXXXXX?XXXXXXXXXXXXXXXXX---------XXXSSS-S--XXXXXXXXXXXSXXXXX