-------------------------------------------------------------xxx--------------------------------------------------------------------------------------
-------------------------------------xxxxxxxxxxxxxxxxxxxxxxxxX--x-------------------------------------------------------------------------------------
-------------------------------------xXXXXXXXXXXXXXXXXXXXXXXXX---x------------SSSSSSSSSSSSSSSSSSSSSSSSSSSSSSS-SSSSSSSSSSXSSSSS--------SSSSSSSSSSSSSSSS
--xxx-------------------------------xxXXXXXXXXXXXXXXXXXXXXXXXX----x-------------[]----[]------------------------------------------------SSS----SSSSSSS
xxx--x--------------E--------------xx-XXXXXXXXXXXXXXXXXXXXXXXX-----x------------[]----[]------XE----------------------------------------SSS----SSSSSSS
xXX---x-----E-SSSSS----------------xS-XXXXXXXXXXXXXXXXXXXXXXXX------x-----------[]----[]---QQQQQQ--------xxxxx-----------------------SSSSSS----SSSSSSS
XXX----x-E-------------------------x--XXXXXXXXXXXXXXXXXXXXXXXX-------x----------<>----[]----------------xxSSS-xxx--------------------------x----------
XXX-----x-------------------------xx--XXXXXXXXXXXXXXXXXXXXXXXX--------x---------------[]---------------xx-SSSSSS-x--------------------------x-------xx
XXX------x-----------------------xxS--XXXXXXXXXXXXXXXXXXXXXXXX---------x--------------[]--xxxxxxxxxxxxxx--SSSSSS--xxxxxxx--------------------xxxxxxxx?
XXX-------x----SSS---------------x----XXXXXXXXXXXXXXXXXXXXXXXX----------x-------------[]-xxSSSSSSSSSSSSS--SSSSSS?SS?SSSS-xxxxxxx------------?S?SSSSSS?
XXX--------x--------------------xx----XXXXXXXXXXXXXXXXXXXXXXXX-----------x------------<>xx-SSSSSSSSSSSSS-----------SSSSSSSSSSSS-x------xxx----SSSSSS--
XXX---------x------------------xx---E-XXXXXXXXXXXXXXXXXXXXXXXX------------x----xxx-----xx--SSSSSSSSSSSSS-----------SSSSSSSSSSSS--x----xxB-x---SSSSSS--
XXX----------xxxxxxxxxxxxxxxxxxx------XXXXXXXXXXXXXXXXXXXXXXXX-----------X-xxxxx--xxxxxx---SSSSSSSSSSSSS--------------------------xxxxx-b--x--------oo
XXX----------XXXXXXXXXXXXXXXXXXXXXXXXXXXXXXXXXXXXXXXXXXXXXXXXX--XXXXXXXXXXXXXXXX--XXXXXXE--XXXXXXXXXXXXXXXXXXXXXXXXXX-XXXXEXXXXX--XXXXXXXXXXXXXXXXXXXX