------------------------------------------------------------------------------------------------------------------------------------------------------
------------------------------------------------------------------------------------------------------------------------------------------------------
--------------------------------------------------------------------------XXXXXXXXXXXXXX--------------------------------------------------------------
--------------------------------------------------------------------------XXXXXXXXXXXX-X--------------------------------------------------------------
-------------------------------------XXX-----------------E----------------XXXXXXXXXXXX-X--------------------------------------------------------------
-------------------------------------------------E-SSSSS----------------S-XXXXXXXXXXXXXX-------------------------------SSSS---------------------------
----------------------------------------------E---------------------------XXXXXXXXXXXXXX-----------------------------------------------------------E--
--------------------------------------------------------------------------XXXXXXXXXXXXXX--------------------------------------------------------------
-----------------------------------------------------------------------S--XXXXXXXXXXXXXX---------------------------X----------------------------------
?QQQQQQQ?-------------------------------------------SSS-------------------XXXXXXXXXXXXXX------------------S?S-----EX---S-----X-----------<>-----------
----------------E---------------------------------------------------------XXXXXXXXXXXXXX-------------------------XXX---------X-----------[]-----------
B-----------------------------------------------------------------------E-XXXXXXXXXXXXXX------------------------XXXX---------XX----------[]---B-------
b-E-----B-----------X--------E-E------------------------------------------XXXXXXXXXXXXXX-----------X-----------XXXXX----EE---XX---E------[]---b-------
XXXXXX-XXXXXXX---XXXXXX-------XXXXX---------------XXXXXXXXXXXXXXXXXXXXXXXXXXXXXXXXXXXXXX--XXXXXXXXXXXXXXXXXXXXXXXXXXXXXXXXXXXXXXXXXXXXXXXXXXXXXXXXXXXX
