------------------------------------------------------------------------------------------------------------------------------------------------------
------------------------------------------------------------------------------------------------------------------------------------------------------
------------------------------------------------------------------------------------------------------------------------------------------------------
------------------------------------------------------------------------------------------------------------------------------------------------------
------------------------------------E-----------------------------------------------------------------------------------------------------------------
--------------------------------SSSSSS----S--------------------------------------?SS---------------------------------------SSSSSSS--------------------
------------------------------------------------------------------------------------------------------------------------------------------------------
-------------B----------------------------------------------------------------------------------------------------------------------------------------
-------------b-------------------E------------------------------------------------------------------------------------------E--E------------E---------
-----------SSXSS---------------SSSSSSS-------------------------------------------------------QQQQ--------------------------SSSSSSS----E----<>---------
B---?QQ------------------<>---------------<>--------------<>------------------E---B-----------------B-----E---B-----QQQ--------------<>---------------
b----------------B-------[]---------------[]---------B----[]----<>------B---------b-------B--E------b---------b---------------------------------------
-------------------------[]---------------[]--------------[]-E--[]------------------------------------------------------------------------------------
XXXXXXXXXXXXXXXXXXXXXX--XXXXXXXXXXXXXXXXXXXXXXXXXXXXXXXXXXXXXXXXXXXXXXXXXXXXXXXXXXXXXXXXXXXXXXXXXXXXXXXXXXXXXXXXXXXXXXXXXXXXXXX--XXXXXXXXXXXXXXXXXX---
