------------------------------------------------------------------------------------------------------------------------------------------------------
------------------------------------------------------------------------------------------------------------------------------------------------------
--------------------[]SSSS-------------------------------------------------------------------------------------------------------------------------?--
--------------------[]SSSS----------------------------------------------------------------------------------------------------------------------------
--------------------[]SSSS----------------------------E-E---------------------------------------------------------------------------------------------
--------------------[]SSSS----------QQQ?QQQ---------SSSSSSS-SS----------------X---------------------------------------------------SSSSS---------------
--------------------[]SSSS---------------------------------E---------------E--X--------------------------E-------------------------------------------S
--------------------[]SSSS------------E------------------------------------XX-X-------------------------<>--------------------------------------------
---------------------]SSSS----------SSSSSSS--------------------------------XX-X-------------------------[]-------------------------E-------------SS---
S---SSSSSSS?SSX------]SSSS---<>--------------E--------------<>-------<>----XX-X-----------------X-------XXX-----------------------SSSSS---------------
S-------SSSSSSX-----S]SSS----[]-------X------X-------E------[]-------[]----XX-X------------S---XX----------------------------------------X----B-------
S-------SSSSSSX--SSSSSSSS----[]-------X---S--X--------------[]-------[]----XX-X-------S-----S-SXX----------B---<>-----B-----<>-----------X----b-------
S----------XX-X--SSS---------[]----E--X------X--------------[]-------[]----XX-X--------------------------------[]-----------[]-----------X-----------X
XXXXXXXXXX-XX-X--XXXXXXXXXXXXXXXXXXXXXXXXXXXXXXXXXXXXXXXXXXXXX-------XX-XXXXX-XXXXXXXXXXXXXXXXXXXXXXX--XXXXXXXXXXXXXXXXXXXXXXXXXXXXXXXXXXXXXXXXXXXXX-X
