------------------------------------------------------------------------------------------------------------------------------------------------------
------------------------------------------------------------------------------------------------------------------------------------------------------
----------------------------S-------------------------------------------------------------------------------------------------------------------------
------XX--------------------]-------------------------------------------------------------------------------------------------------------------------
------XX--------------------]-------------------------------------------------------------------------------------------------------------------------
-S----XX-------------------X]-------------XXXX-------------------------XX------------------------------------------------------------------------XX---
------XX-------------------[]------------------------------------------XX-----------------------------------------------------------------------XXX---
------XX-------------------[]--------------------------------------XXX-XX----------------------------------------------------------------------XXXX---
------XX-------------------[]-----------------------------------------EXX-------------------------B-------------------------------------------XXXXX---
------XX------------------Q[]----------------------------------------<>XX-----------------B-------b------------------------------------------XXXXXX---
------XX-------------------<>--------------------------------------X-[]XX-----------------b--?-B------?QQ------------------------------------XXXXXX---
------XX--------------------------B----------------------------E---XX[]XX-----------------B----b---------------------------------------------XXXXXX---
------XX--------X-----------------b--------------------------------XX[]XX--------X------------------------------------------------EE---X-----XXXXXX---
XXXXXXXXXXXXXXXXXXXXXXXXXXXXXXXXXXXXXXXXXXXXXXXXXXX--XX--XXXXXXXX--XXXXXXXXXXXXXXXXXXXXXXXXXXXXXXXXXXXXXXXXXXXXXXXXXXXX--XXXXXXX--XXXXXX-----XXXXXXXXX
