------------------------------------------------------------------------------------------------------------------------------------------------------
------------------------------------------------------------------------------------------------------------------------------------------------------
------------------------------------------------XXXXXXXXXXX----------------------------------------------------------------S--------------------------
------------------------------------------------XXXXXXXXXXX-------------------------------------------------------------------------------------------
-----------------------------E------------------XXXXXXXXXXX----------------------------------------------SSSS---------------------E-------------------
----------XX---------E-SSSSS------------------S-XXXXXXXXXXX-----------------------------------------------------------SSSSSS----QQQQQQQQ--------------
---------XXX------E-----------------------------XXXXXXXXXXX------------------------X--E-X-------------------------------------------------------------
--------XXXX------------------------------------XXXXXXXXXXX-----------------------XX----X-------------------------------------------------------------
-------XXXXX---------------------------------S--XXXXXXXXXXX-----------------------XXE---X--------X-EE-------X----------------------E-----------------X
------XXXXXX------------SSS---------------------XXXXXXXXXXX----------------------XXXQQ?QX--------XSSSSSSSSSSX------------------QQQQQQQQQ-------------X
------XXXXXX------------------------------------XXXXXXXXXXX--------------------XXXX-----------------------------------------------------------------XX
------XXXXXX----------------------------------E-XXXXXXXXXXX-------------------SX--------------------------------------------------------------E---EXXX
X-----XXXXXX------------------------------------XXXXXXXXXXX-----------X-------------------------------------------------------------------------------
X-----XXXXXX----------XXXXXXXXXXXXXXXXXXXXXXXXXXXXXXXXXXXXX--XXXXXXXXXXXXXXXXXXXXXXXXXXXXXXXXX--XXXXXXXXXXXXX----XXX------XXXXXXXXXXXXXXXXXXXXXX--XXXX
