------------------------------------------------------------------------------------------------------------------------------------------------------
------------------------------------------------------------------------------------------------------------------------------------------------------
------------------------------------------------------------------------------------------------------------------------------------------------------
------------------------------------------------------------------------------------------------------------------------------------------------------
--------------E--------------------------------------------------------------------------------------E------------------------------------------------
---------?SES-------------------------------------------------XX---------------------------------SSSSSS----S------------------------------------------
----------->--------------------------------------------------[]--------------------------------------------------------------------------------------
-----------]--------------------------------------------------[]--------------------------------------------------------------------------------------
-------E---]---------------------------SSSSSSX--?-------------[]----------------------------------E---------------------------------------------------
------<>---]-----<>-------------------------------------------<>SSSSSS---------------------------SSSSSS-----------------------------------------------
------[]--<>-----[]------------------------------------------------------------------------<>--------------<>-----------X-----------------------------
>-----[]--[]-----[]--------------------------------------------E------------SS--------B----[]--------------[]-----------X----------E------------------
]--E--[]--[]-----[]--------------------------------------XX------E-------------------------[]--------------[]-----------X----------------------EE-----
XXXXXXXXXXXXX----XXXXXXXXXXXXX---XXXXXXXXXXXXXXXXX--XXXXXXXXXXXX<>XXXXXXXXXXXXXXXXXXXXXXXXXXXXXXXXXXXXXXXXXXXXXXXXXXXXXXXXXXXXXXXXXXX--XXXXXXXXXXXXXXX
