------------------------------------------------------------------------------------------------------------------------------------------------------
------------------------------------------------------------------------------------------------------------------------------------------------------
----------------------------------------------------------XXXXXXXXXXXXXXXXXXXXXXX----------------SSSSSSSSSSSSSSSSSSSSSSSSSSSSSSSSSSSSSSSSSSSSSS---SS--
----------------------------------------------------------XXXXXXXXXXXXXXXXXXXXXXX------------------[]---[]--------------------------------------------
--------------------------------------E-------------------XXXXXXXXXXXXXXXXXXXXXXX------------------[]---[]-------E------------------------------------
X-----------------XXX---------E-SSSSS-------------------S-XXXXXXXXXXXXXXXXXXXXXXX------------------[]---[]---QQQQQQ------E----------------------------
]----------------XXXX------E------------------------------XXXXXXXXXXXXXXXXXXXXXXX------------------<>---[]----------------------SSS-------------------
>---------------XXXXX-------------------------------------XXXXXXXXXXXXXXXXXXXXXXX-----------------------[]----------------------SSSSSSS---------------
---------------XXXXXX----------------------------------S--XXXXXXXXXXXXXXXXXXXXXXX-----------------------[]----------------------SSSSS-----------------
B-------------XXXXXXX------------SSS----------------------XXXXXXXXXXXXXXXXXXXXXXX-----------------------<]---SSSSSSSSSSSSSSSSS--SSSS-------------SSS-X
]-------------XXXXXXX-------------------------------------XXXXXXXXXXXXXXXXXXXXXXX------------------------>---SSSSSSSSSSSSSSSSS--------------------SSS-
]-------------XXXXXXX-----------------------------------E-XXXXXXXXXXXXXXXXXXXXXXX----------------------------SSSSSSSSSSSSSSSSS---------------X-SS-SSS-
--------B-----XXXXXXX-------------------------------------XXXXXXXXXXXXXXXXXXXXXXX-----------X----------------SSSSSSSSSSSSSSSSS---------------X-SS-SSS-
XXXXXXXXX-----XXXXXXX----------XXXXXXXXXXXXXXXXXXXXXXXXXXXXXXXXXXXXXXXXXXXXXXXXXX--XXXXXXXXXXXXXXXX--XXXXXE--XXXXXXXXXXXXXXXXXXXXXXXXXXXXXXXXXXXXXXXX-
