------------------------------------------------------------------------------------------------------------------------------------------------------
------------------------------------------------------------------------------------------------------------------------------------------------------
X------------------------------------------------E------------------------------------------------------------------------------------XXXXX-----------
---------------------------------------------------------------------------------------------------------------------------------------[]-------------
------------------------------------------------------------------------XX-------------------------------------------------------------[]-------------
---------------------------------------XXX---------------------------------------------------------------------------------------------<>--XXXX-------
--------------------------------------XXXX----------------------------E----------o----ooo-------------------------------------------------------------
-----------------o------XX-------X---EXXXX------------------------XXXXXX-------------------XXXX-------------------------------------------------------
------------------E-----XX----------XXXXXX---------------------------------XXX--------------------------------------o-------------------------S--S----
---------------SSSSS----XX---------XXXXXXX---------------------------------------------XXXX----------------oooooooooSooo----------------XXXX---S------
------------E--E-------XXX-------EXXXXXXXX--------------------XXXXX----------------------------------------ooooooooo-ooo------------------------S-----
>-----B------------E---XXX-------XXXXXXXXX------------------------------------------------XXXXX-------------------------------------------------------
]----------------------XXX------XXXXXXXXXX-------XX-----------------------------XXXXXXX-----------------XXXXXXXXXXXX<XEXXXX---------------------------
XXXXXXXXXXXXXXXXXXXXXXXXXX---XXXXXXXXXXXXXXXXXXXXXXXXXXXXXXX--------------XXX---------------------------XX----------------X-XXXXXXXXX---------XXXXXXXX
