------------------------------------------------------------------------------------------------------------------------------------------------------
------------------------------------------------------------------------------------------------------------------------------------------------------
------------------------------------------------------------------------------------------------------------------------------------------------------
------------------------------------------------------------------------------------------------------------------------------------------------------
------------------------------------------------------------------------------------------------------------------------------------------------------
---------------------------------------------?-----------SSS----SQQS----------------E---------------------------E--S------S------------------XS-------
-----------------------------------------------------------------------------------<>----------<>--------------<>---------------------------EX--------
-----------------------------------------------------------------------------------[]----------[]--------------[]--------------------------XXX--------
--------<>-----Q--Q-?--------------------------------------------------------------[]----------[]--------------[]-------------------------XXXXS-------
----<>--[]----------------S----------------Q-Q--Q-----S----------SS------X--SSS----XXX----<>--QQQ?-E----------SXXS-----Q--------<>-------XXXXX--------
<>--[]--[]--------------E-----------------------------------------------XX----------------[]------<>-<>--------------------<>---[]------XXXXXX--------
[]--[]--[]-------------------------------------------------------------XXX----------------[]------[]-[]--<>--------<>------[]---[]-----XXXXXXX--------
[]--[]--[]--------------------X---------------------------------------XXXX----------------[]------[]-[]--[]--------[]------[]---[]----XXXXXXXX--------
XX--XX--XXXXXXXXXXXX>XXXXXX---XXXXXXXXXXXXXXXXXXXXXXXXXXXXXXXXXXXXXXXXXXXXXXXXXXXXXXXXXXXXXXXXXXXXXXXXXXXXXXXXXXXXXXXX-XXX-XX--XXXXX-XXXXXXXXXXXXXXXXX
