------------------------------------------------------------------------------------------------------------------------------------------------------
------------------------------------------------------------------------------------------------------------------------------------------------------
---------------------------------------------------------------------------------------?--------------------------------------------------------------
------------------------------------------------------------------------------------------------------------------------------------------------------
-------------------------------------------------------E----------------------------------------------------------------------------------------------
---------------------------------------------------SSSSSS----S--------------------------------------------SSSSSS----------XXXXXXXXXXXXXXXX-----------S
--------------EX-------------------------------------------------------------------------SS-----------------------------------[]-------[]-------------
---------------X------------------------------------------------------------------------------X-------------------------------[]-------[]-------------
-----------X---X--------X-EE----X------------E------E--------------------------------SS------XX-------B-----------------------[]-------[]-------------
---------X-XSS?X--------XSSSSSSSX-----------<>-----SSSSSS-----------------------------------XXX------XXXXESSSSSS--------------[]-------[]------------<
-E--QQQQQX-X-------------------------------------------------<>--------------X----B--------XXXX-----XXXXXX--------------------<>-------<>------------[
-------------------------------------------------------------[]---------B----X----b-------XXXXX----XXXXXXX-------------------------------------------[
-------------------------------------------------------------[]--------------X-----------XXXXXX---XXXXXXXX----------B----------E--------E------------[
XXXXXXXXXXXXXXXXXXXXX--XXXXXXXXXXXXEEXEXXXXXXXXXXXXXXXXXXXXXXXXXXXXXXXXXXXXXXXXXXXXXXXXX-XXXXXXXXXXXXXXXXXXXXXXXXEXXXXXXXXXXXXXX-XXXXXXXX-XXXEXXXXX-XX
