------------------------------------------------------------------------------------------------------------------------------------------------------
------------------------------------------------------------------------------------------------------------------------------------------------------
-------------------------------------------SS---------------------------------------------------------------------------------------------------------
-------------------------------------------[]---------------------------------------------------------------------------------------------------------
E------------------------------------------[]---------------------------------------------------------------------------------------------------------
>----------------------------X-------------[]--------------E---------E-E-E-E------------S------------------XS-----------------------------------------
]X-----------------------------------------[]-------------<>------E---<><><>------------------------------EX------------------------------------------
]X-----------------------E-----------------[]-------------[]----------[][][]-----------------------------XXX------------------------------------------
]X----------------------<>-----------------[]----------Q--Q]-Q--------QQQQQQ----------------------------XXXXS------------------------B----------------
]S------------------<>--[]-----------------<>----<<--------QQ------------------------Q--------<>-------XXXXX-----------------B-------b----------------
SS------------------[]--[]-----------------------[]--------------------------------------<>---[]------XXXXXX-----------------b--?-B------?QQ------E---
SS------------------[]--[]------------------E----[]------------------------------<>------[]---[]-----XXXXXXX-----------------B----b-------------------
SS------------------[]--[]------------X----------[]------------------------------[]------[]---[]----XXXXXXXX--?------X--------------------------------
XXXXXXXXXXXXXXXXXEXXXX--XXXXXXX-------XXXXXXXXXXXXXXXXXXXXXXXX--------XXXXXXXXXXXXXX-XXX-XX--XXXXX-XXXXXXXXXXXXXXXXX-XXXXXXXXXXXXXXXXXXXXXXXXXXXXXXXXX
