------------------------------------------------------------------------------------------------------------------------------------------------------
------------------------------------------------------------------------------------------------------------------------------------------------------
------------------------------------------------------------------------------------------------------------------------------------------------------
------------------------------------------------------------------------------------------------------------------------------------------------------
----------------------------------------------------------------------------------------------------------------------E-------------------------------
--------------------------------------------------------------------------------SSSSS----------------------------SSSSSSSSSSS--------------------------
SSSSSS--------------------------ES---------------E--------------------------------------------------------------------------------------------------X-
----------------B--------S-------------QQQ------<>--------------------------------------------------------------------------------------------------X-
----------------b-------------------------------[]-------------------------------------------------------------------------------X-----------------EX-
S--------------XXX--S------------------------QQQQQQQQQQ?---------X---------------------------<>---------------------------SSSSSSSX-----------------XX-
--------------XXXX-------------------------------------------?---X---------------------------[]----------------------X-----------------------------XX-
-------------XXXXX---------B-------------------------------------X---------------------------[]----------B-----------X-----------------------------XX-
------------XXXXXX---------b--------------B------------X---------X------X-----------------E--[]----------b-----------X---------------------------E-XX-
X------S---XXXXXXXXXXXXXXXXXXXXXXXXXXXXXXXX--XXXXXEEXXQXXXXXXXXXXXXXXXXXXXXXXXXXXX----XXXXXXXXXX---XXXXXXXXXXXXXXXXXXXXXXXXXXXXXXXXXXXXXXXXXXXXXXXXXXX
