------------------------------------------------------------------------------------------------------------------------------------------------------
------------------------------------------------------------------------------------------------------------------------------------------------------
SSSSSSSSSSSSSSSS--------------------------------------------------------------------------------------------------------------------------------------
------------[]----------------------------------------------------------------------------------------------------------------------------------------
------------[]-------------------------------------------------------------------------------------------------E--------------------------------------
------------[]----------------------------------------------------------------------------------------SSSSSSSSSSSSS----------------------------------S
-S----------[]----------X--EX-------------------------------------------------------------?QQQQQQ-----------------------------------------------------
------------<>----------X---X-------------------------------------------------------------------------------------------------------------------------
S-----------------X---X-X---X--------X-EE----X--------------ooo------------------------------------------------E------X-----------------------------S-
SS---<>-----------XSSSX-XSS?X--------XSSSSSSSX--------------ooo------------------------------------------------QQ?QQQQX-------------------------------
SS---[]----S-S-S------------------------------------------------------------oo-----QQQ?---S---------S-------------------------------------------------
SS---[]----S-S-S------------------------------------------------------------oo-----------------------------------------------------------------------E
-----[]----S-S-S-------------------------------------------------------------------------------------------X------------------E-----------------------
XX---[]----S-S-SXXXXXXXXXXXXXXXXXX--XXXXXXXXXXXXEEXEXXXXXXXXXXXXXEEXEXXXXXXXXXX------------EES-------------XXXXXXXXXXXXXXXXXX--XXXXXXXXXXXXXXXXXXXXXXX
