-------------------------------------------------------------E----------------------------------------------------------------------------------------
------------------------------------------------------------------------------------------------------------------------------------------------------
------------------------------------------------------------------------------------------------------------------------------------------------------
------------------------------------------------------------------------------------------------------------------------------------------------------
-------------------------------------------------------------------------------------------------------------------oooo----------E-----------o------oo
------------XXX--------XXXX--------XXX--------------XXXXXXXX----------XX--XXXXX-----------XXXXXX------------------XXXXX---------------------oo--------
SSSSS-----------------------------------------XX------------------XX----------------------------------XXX--------------------------XXXXXX-------------
SS-----------------oo---------------------------------------------------------------------------------------------------------------------------------
-------------------SS---------------------------------------------------------------------------------o-o------------------------------------XXX------
o-SSS------------------------------------XX------------------------------------------XX---------------o-o-XXX----------------XXX---------------------X
o-----------------------------------------------------------------------------------------------------------------------------------------------------
]-----------------------------------------------------------------------------------------------------------------------------------------------------
]----------o---o--------------------------------------------------------------------------------------------------------------------------------------
XXXXXX-----X---X--------------XXX-----------------------------------------XXXXXXXX----------------------------XXEXXXXXX--XXXX-------------------------
