------------------------------------------------------------------------------------------------------------------------------------------------------
------------------------------------------------------------------------------------------------------------------------------------------------------
------------------------------------------------------------------------------------------------------------------------------------------------------
------------------------------------------------------------------------------------------------------------------------------------------------------
--------------------------------------------E---------------------------------------------------------------------------------------------------------
E-----------------------------------SSSSSSSSSSSS------------------------------------------------------------------------------------------------------
------------------------------------------------------------------------------------------------------------------------------------------------------
------------------------------------------------------------------------------------------------------------------------------------------------------
--------------------------------------------E-------X---------------X--------------ooo-----------------------E----------------------------------------
QQ------------------------------------------QQ?QQQQQX---------------XS-------------ooo----------SSS----E----<>--------------------E--S---------------X
---------------------B--------------------------------------------------------------------------------<>-------------------------<>--------QE--------X
---------------------b---------------------------------------------------------------------------------------------------------------------<>------XEX
X--------E-----------BEE------------------------------------E--------------------------o----------------------------------------------------------XXXX
X----XXXXXXXXXXXXXXXXXXXXXXXXXXXXXXXXXXXXXXXXXXXXXXXXXXXXXX--XXXXXXXXXXXEEXEXXXXXXXXXXXXXEEXX-XXXXXXXXXXXXXXXXXXXXXX---XXXXXXXXXXXXXXXXXXXXXXXXXXXXXXX
