------------------------------------------------------------------------------------------------------------------------------------------------------
------------------------------------------------------------------------------------------------------------------------------------------------------
------------------------------------------------------------------------------------------------------------------------------------------------------
------------------------------------------------------------------------------------------------------------------------------------------------------
------------------------------------------------------------------------------------------------------------------------------------------------------
------------XX--XXX----EXXXX---------XXXXXXXXXXXXXXXX-----------------X-----------------------QQ------------------E----------SSSSS-----?--------------
--------XX-------------------------------[]-------[]-------------------------------------------------------------<>-----------------------------------
-----------------------------------------[]-------[]----------------X--------------------------------------------[]-----------------------------------
----------------------o------------------[]-------[]-------------------------------------------------X-----------[]--------------X--------------------
?--------------------S?SSSSSS------------[]-------[]-----------<--------------------------------SSSSSX------SQS--[]-----------EXXX--------------------
---------------------SSS-----------------<>-------<>-----------[]-------------------------------------------------------------------------------------
---------------------SS----------------------------------------[]------------------------------E------------------------<>-------------------------XXX
oo---------------------E------------------E--------E-----------[]---------------X---------------------------------------[]-------------------B-----XX-
XX--------------XXXXXXX-XXXXXX---XXXXXXXXXX-XXXXXXXX-XXXEXXXX--XXXXXXXXXXXXXXXXXXXXXXXXXXXXXXXXXXXXXXXXXEEXEXXXXXXXXXXXXXXXXXXXXXXXXEEXXXXXXXX-----XX-
