------------------------------------------------------------------------------------------------------------------------------------------------------
------------------------------------------------------------------------------------------------------------------------------------------------------
-X-----------------------------------------------oo---------------------------------------------------------------------------------------------------
----------------------------------------------------------------------------Q-------------------------------------------------------------------------
----------------------------------------------------------------o-ooo------------XXX------------------------------------------------------------------
------------E---XXX------------------------------XXX---------XX-----------------------------XXoo----XX------------------------------XXX-------------->
---------------XXXX-------------------------------------------------------XX------------------------------------------------------------------------X]
--------------XXXXX------------------------------------------------XX------------------------------------------------------------------------------XX]
-------------XXXXXX----------------------------------------------------------------------------------------------------E--------------------------XXX]
-----------<>XXXXXX-----------------------XXXX------XXXXX-----------------------------XXXXXX----XX-----XX------------XXX-------------------------XXXX]
>----------[]XXXXXX----------------------------------------------------------------------------------------------------------------------------->XXXX]
]---------X[]XXXXXX---------------------------------------------------XXXXX--------------------------------XXX---XX---------------------S------XXXXXX]
---------XX[]XXXXXX-------XX------------------------------------------------------------------------------------------------------------S------XXXXXX]
XXXXXXXXXXXXXXXXXXXXXXXXXXXXXXXXXXXXX--XXXX--XXXX---------XXXX--XXXX--------------------------------------------------------------------S------XXXXXXX
