------------------------------------------------------------------------------------------------------------------------------------------------------
------------------------------------------------------------------------------------------------------------------------------------------------------
------------------------------------------------------------------------------------------------------------------------------------------------------
------------------------------------------------------------------------------------------------------------------------------------------------------
---------------------------------------------------------------------------------------------------------------E--------------------------------------
---------------------------------------------------------SSSSSSS---------------E------E------------------------S--------------------------------------
----------------------------------------------------------------------------E-------------------------------------------------------------------------
------o--------------------------------------------------------------------------------------------------------?-----------------X-------oooo-----oooo
----------------------------------------------B-----------E--E-----------XSSSSSSSSSSSS----------------------------------------E--X-------oooo-----oooo
----SSS---X-----------------------------------b----------SSSSSSS--------XX-----------------------QQ----X----------------------X--X--------------------
-------EE-X---------------------------?-B--B------?QQ------------------XXX----oooooo-------------------X-------X-----------E--X--X--------------------
----SSSSSSX-----------------------------b--b--------------------------XXXX-----------------------------X-------X-----------X--X--X----XXXXXXXXXEXXXXXX
----------------------------E----------------------------------------XXXXX----oooooo-------------------X-------X-----------X--X--X----X---------------
XXXXXXXXXXXXXXXXXXXXXXXXXXXXXXXXXXXXXXXXXXXXXXXXXXXXXXXXXXXXX--XXXXXXXXXXXXXXXXXXXXXXX-----X--XXXXX--XXXXXXXXXXXX-XXXXXXX--X--X--X----X---------------
