------------------------------------------------------------------------------------------------------------------------------------------------------
------------------------------------------------------------------------------------------------------------------------------------------------------
------------------------------------------------------------------------------------------------------------------------------------------------------
------------------------------------------------------------------------------------------------------------------------------------------------------
-----XXX----ooo----------------E----------------------------------------------------------------------------------------------------------------------
-----------------------SSSSSSS-----------S----------SS--------------------------XXX--------XXXX--------XXX---------XXX------XXX--------XXXX--------XX-
-----------------------------------------S-----------------E-----------XX-----------------------------------------------------------------------------
--------------------------------------------------------------XX-----------------------oo------------------------------------------oo-----------------
-----------------------------------------SSS-------------------------------------------SS------------------------------------------SS-----------------
-----------------------------------------SSS----------XX-------o------------------------------------------------?-------------------------------------
-------------------------------------X---SSS-------------------o--XX----------------------------------------------------------------------------------
------------------------------------------SS-------------------------------------------------------------------------------------------------------o--
EE-------------------------E--------------SS-----------------------------------o---o------------------------XXX------------o---o-------------------ooo
XXXXX---------XXXXXXXXXXXXXXXXXXXXXXXXXXXXXXXXXXXX-----------------------------X---X--------------XXX----------------------X---X-------------------XXX
