------------------------------------------------------------------------------------------------------------------------------------------------------
------------------------------------------------------------------------------------------------------------------------------------------------------
SSSSSSSSSSSSSSSSSSSSSSSSSSS-----SSSSSSSSSSSSSSSS--------SSSSSSSSSSSS?SSSSSSSSSSSSSSSSSSSSSSSSSSSSSSSSSSSSSSSSSSSSSSSSSSSSSSSSSSSSSS-------------------
SS------------------------------SSSS--------------------SSSS---------SSSSSSSSSSSSSSSS--SSSSSSS-------SSSSSSSSSSSSSSS----------------------------------
SS------------------------------SSSS--------------------SSSS---------SSSSSSSSSSSSSSSS--SSSSSSS-------SSSSSSSSSSSSSSS----------------------------------
SS---E---------E----------------SSSS--------------------SSSS---------SSSSSSSSSSSSSSSS--SSSSSSS-------SSSSSSSSSSSSSSS----E-----------------------------
----<>--------->------------------------------------------------------------------------------------oSSSS--------------<>-----------------------------
----[]--------->-------------------------------------------------------------------]-----------------SSSS--------------[]-----------------------------
----[]--------<>-----------------o-----------------<>----o-------------------------------------------SSSS---------<----[]-------------------------XSSS
E--?[]S-------[]----------------S?SS---------XXX---[]---S?SS------------------<>SSSSS--SSSSSSS--Q<>--SSSS<---E---<>---?SSS--E--------------------XX---
>---[]--------[]--<>------E-----SSS----------------[]---SS----<>------------X-[]SSSSS------------[]---------<>---[]--------<>----SS------E------XXX--<
]---[]----<>--[]--[]-----<>-----SS-----------------[]---SS----[]---------EEXX-[]SSSSS------------[]---------[]---[]--------[]----SS-----<>-----XXXX--[
]---[]----[]--[]--[]-----[]-------E-EE---X---------[]-----E-E-[]----------XXX-[]SSSSS----------X-[]---------[]---[]--------[]----SS-----------XXXXX--[
XXXXXXXX--XX--XX--XX---XXXXXXXXXXX-XXXXXXX---------XXXXXXX-XXXXXXXXXX-XXEXXXX-XXXXXXXXXXXXXXXXXXXXXXXXXXXXXXXXXXXXXXXX----XXX----XXXXXXXXXXXXXXXXXXXXX
