------------------------------------------------------------------------------------------------------------------------------------------------------
------------------------------------------------------------------------------------------------------------------------------------------------------
SSSSSSSSSSSSSSSSSSSSSSSSSSSSSSSSSSSSSSSSSSSSSSSSSSS-----------------------------------------------oo-----------------------SSSSSSSSSSS----------------
-----------------------------------------------------------------------------------------------------------------------------[]-----------------------
-----------------------------------------------------XXX-------E------------------------Eoo----------XXXXXX------------------[]-----------------------
--------------------------------------------------------------------XXX-----------------XXXX---------------------------------[]-----------------------
--------------------------------------------------------------------------------------------------------------oo-------------<>-----------------------
------------------------------------------------------------------------------------------------------------------------------------------------------
----------------------------------------------------------SSSSS??-------------------------------XXXXX-------------------------------------------------
-X-------------------<>--------------------------XXX----------------------------------XXXXXXX--------------------------------------------------------X
-X-------------<>----[]-----------SS------------EXXX-XXX-----------------------------------------------------------XXX---------------XX-------------XX
-X-------------[]----[]----<>-----SS-----------XXXXX------------------------------------------o-------------------------------------XXX---<>-------XXX
EX-------------[]----[]--E-[]-----SS----------XXXXXX----------------------------XXXX---------XXX------------------------------E-----------]]------XXXX
XX----XXXXXXXXXXXXXXXXXXXXXXXXXX--SX--XXXXXXXXXXXXX-------XXXXXXXX--XXXXXXXXXX--------------------------------XXXX-----XXXXXX-XEXXXEXXXXXXXXXXXXXXXXXX
