------------------------------------------------------------------------------------------------------------------------------------------------------
------------------------------------------------------------------------------------------------------------------------------------------------------
--------------------------------------------------------------------------------------E---------------------------------------------------------------
------------------------------------------------------------------------------------------------------------------------------------------------------
--------------------------------------E---------------------------------------------------------------------------------------------------------------
----------------SSS------------------SQS--SQS-------------------------------XXX-----------------------------------------------------------------------
---------------------------------------------------------------------------XXXX-------------------E---------------------------------------------------
----------------------------XX------------------------o------XX-----------EXXXX-----------------------------------------------------------------------
?---------------SSS--------XXX-------------------------E-----XX----------XXXXXX----------------------------------------------ooo----------------------
---ESSSS------------------XXXX-------SQS--S?S-------SSSSS----XX---------XXXXXXX----------------------------------------------ooo----------------------
-------------------------XXXXX-------------------E--E-------XXX-------EXXXXXXXX---------------------XX------------------------------------------------
------------------------XXXXXX--------------------------E---XXX-------XXXXXXXXX-----------------------------------------------------------------------
-----------------------XXXXXXX-----E------------------------XXX------XXXXXXXXXX-------X----------------------------EE---------------------------------
XXXXXXXXXXXXXXX----XXXXXXXXXX--XXXXXXXXXXXXXXXXXXXXXXXXXXXXXXXX---XXXXXXXXXXXXXXXXXXXXXXXXXXXXXX----------XXXXXXXXXXXXXXXXXXXXXXX---XXXXXXXXXXX--XXXX-
