------------------------------------------------------------------------------------------------------------------------------------------------------
------------------------------------------------------------------------------------------------------------------------------------------------------
------------------------------------------------------------------------------------------------------------------------------------------------------
------------------------------------------------------------------------------------------------------------------------------------------------------
------------------------------------------------------------------------------------------------------------------------------------------------------
--------------------------------------------------XXX-----XXXXXXE-----------------------------XXXXXXX-----------------------------------XXXXX---------
--------------------------------XXXXS-------XX------------------------------------E------------------------XXX----------------------------------------
-------------------------------XXXXX------------------------------------------------------------------------------------------------------------------
------------------------------XXXXXX-----------------------------------------------------------------------o-o---------------------E------------------
-----------------------------XXXXXXX--------------XXX-----------------------------------XXX----------------o-o-XXX----E----------------------------XX-
-----------------------------XXXXXXX------------------------------------------------XX------------------------------------E---------------------------
-----------------------------XXXXXXX------------------------------------------------------------------------------------------------------------------
E-----------------EE---X-----XXXXXXX-----------------------------XXXXEXXEX----XXX---------------------------------------------X-----------------------
XXXXXXXXXXXXXXXX--XXXXXX-----XXXXXXXXX-----------------------------------------------------------------------------XXEXXXXXXXXX-------XXXXXXXXXX------
