------------------------------------------------------------------------------------------------------------------------------------------------------
------------------------------------------------------------------------------------------------------------------------------------------------------
--SSSSSSSSSSSSSSSS-------------SSS---[]SSSSSSSSSSSSS--------------------------------------------------------------------------------------------------
--SSSS-------------------------------[]SSSSSSSSSSSSS--------------------------------------------------------------------------------------------------
--SSSS-------------------------------[]SSSSSSSSSSSSS--------------------------------------------------------------------------------------------------
--SSSS-------------------------------[]SSSSSSSSSSSSS-------------------------------SSS------------------------------SSS-----Q-------------------------
-------------------------------------[]SSSSSSSSSSSSS-----------------XX----------------------------X-X------------------------------------------------
---------------------XXX-------------[]SSSSSSSSSSSSS----------------XXX---------------------------XX-X------------------------------------------------
---o----------------------------------]SSSSSSSSSSSSS---------------XXXX--------------------------XXX-X--X---------------------------------------------
--S?SS---------XXX----------X---------]SSSSSSSSSSSSS---------E----XXXXX--------E---SSS----<E----XXXX-X--------------------------------X------------XXX
--SSS-------------------SSS-S--SSSSSSSSSSSSSSSSSSSSS----E---<>---XXXXXX-------<>----------[>---XXXXX-X-----------XXXXXXXXXXXXXX---<>--XX--------XXXX--
--SS--------------------SSS-S--SSSSSSSSSSSSSSSSSSSSS---<>---[]--XXXXXXX-------[]----------[]--XXXXXX-X----------XXX---------------[]--XXX------XXXX---
----E-EE---X------------SSS-S--SSSSSSSSSSSSSSSSSSSSS>--[]---[]-XXXXXXXX-------[]----------[]-XXXXXXX-X---------XXXX---------------[]--XXXX----XXXXX---
XXXX-XXXXXXX---------XXXSSS-S--XXXXXXXXXXXXXXXXXXXXX]--XX---XXXXXXXXXXXSXXXXXXXXXXXXXXXX--XXXXXXXXX--X-------XXXXX----------------XXXXXXXXXXXXXXXX----
