------------------------------------------------------------------------------------------------------------------------------------------------------
------------------------------------------------------------------------------------------------------------------------------------------------------
------------------------------------------------------------------------------------------------------------------------------------------------------
------------------------------------------------------------------------------------------------------------------------------------------------------
------------------------------------------------------------------------------------------------E-E---------------------------------------------------
XXXXX-------------------------------------------------------------------------QQQ?QQQ---------SSSSSSS-SS----------------X----------------------------X
-----------------------------------------------------------------------------------------------------E---------------E--X-------------------------E---
-----------------------------------------------------------B--------------------E------------------------------------XX-X-----------------------------
-----------------------------------------------------------b------------------SSSSSSS--------------------------------XX-X----------------------E------
---------------------------------------------------------SSXSS---------<>--------------E--------------<>-------<>----XX-X-----------------------------
--------------------------B-------------------E----B-------------------[]-------X------X-------E------[]-------[]----XX-X-----------------------------
--------------------------b------------------------b-----------B-------[]-------X------X--------------[]-------[]----XX-X-------S-------X-------------
E---E--------X------------BEE------------------------------------------[]----E--X------X--------------[]-------[]----XX-X-----------------------------
XXXXXXXXXXXXXXXXXXXXXXXXXXXXXXXXXXXXXXXXXXXXXXXXXXXXXXXXXXXXXXXXXXXX--XXX-XXXXXXXXXXXXXXXXXXXXXXXXXXXXXX-------XX-XXXXX-XXXXXXXXXXXXXXXXXX--------XXXX
