------------------------------------------------------------------------------------------------------------------------------------------------------
------------------------------------------------------------------------------------------------------------------------------------------------------
S----SSSSSSSSSSSSSSSSSSSSSSSSSSSSSSSSSSSSSSSSS--------------------------------------------------------------------------------------------------------
S----SSSSSS--SSS------------SSSSSSSS------------------------------------------------------------------------------------------------------------------
S----SSSSSS--SSS------------SSSSSSSS--E----------------------------------------------------------------------------------------SSS---SSSS-------------
S--------SS---S-------------SSSSSSSS--QQ---------------------------------------------XX--XXXXX---------S----------XQQ?QQX-----------------------------
SS-------SS---S---------------------------------------------E-----------XX------XX---------------------S----------X-----X-----------------------------
SS-------SS---S------------------------------------------------XX-------------------------------------------------X-----X------X----------------------
SS---ooooSS---S??--------------------------------------------------------------------------------------SSS--------XE-E--X------XEE------X-------------
SSS--SSSSSS---S?--------------SSSSSS--QQ--QQQQ--S-----XXXS------o--------------------------------------SSS--------XQQ-QQX------XSSSSSSSSX---------XXX-
SSS---------------------------SSSSSS----------------------------o--XX----------------------------------SSS--------------------------------------------
-SS---------------------------SSSSSS--------------------------------------------------------------------SS--------------E-----------------------------
----------------------------------SS------------------------------------------------------------------X-SS----------------------------------XXX-------
XXXXXXXXXXXXXXXXXX--XX--XX---XXXXXXXXXXXXXXXXX-------------------------------------------XXXXXXXX-----XXXXXXXXXXXXXXXXXXXXXXXXXXXXXXXXXXX-------------
