------------------------------------------------------------------------------------------------------------------------------------------------------
------------------------------------------------------------------------------------------------------------------------------------------------------
-----------------------------------------------------------?------------------------------------------------------------------------------------------
------------------------------------------------------------------------------------------------------------------------------------------------------
----------------E-------------------------------------------------------------------------------------------------------------------------------------
---------------SQS--SQS-------------------SSSSS--------------------------------------------------------------------------------------------------SSSSS
-------------------------------------------------------------SS-------------X----------------------------------------ES--------------E------------[]--
-----XXX----------------------------------------------------------X--------XX------------------------B--------S------------QQ-------<>------------[]--
----XXXX---------------------<>------------E-------------SS------XX-------XXXS-----------------------b-----------------------QQ-----[]------------[]--
---XXXXX-------SQS--S?S------[]-----------SSSSS-----------------XXX------XXXX-----------------------XXX--S-----------------------QQQQQQQQQQ-------[]--
--XXXXXX---------------------[]------------------X----B--------XXXX-----XXXXX----------------------XXXX-------------------------------------------<>--
-XXXXXXX---------------------[]-B---<>-----------X----b-------XXXXX----XXXXXX---------------SSS--XXXXXX---------B-------------------------------------
XXXXXXXX-----E----------------------[]-----------X-----------XXXXXX---XXXXXXX--------X------------XXXXX---------b-------------B--------------------E--
XXXXXXX--XXXXXXXXXXXXXXXXXXXXXXXXXXXXXXXXXXXXXXXXXXXXXXXXXXX-XXXXXXXXXXXXXXXXXXXXXXXXXXXXXXXXXXXXXXXXXXXXXXXXXXXXXXXXXXXXXXXXXX--XXXXXEEXXXXXXXXXXXXXX
