------------------------------------------------------------------------------------------------------------------------------------------------------
------------------------------------------------------------------------------------------------------------------------------------------------------
------------------------------------------XXXXXXXXXXXXXXXXXXXXXXXXXXX--------------SSSSSSSSSSSSSSSSSSSSSSSSSSS---------------SSSSSSSSSSSSSSSS---------
------------------------------------------XXXXXXXXXXXXXXXXXXXXXXXXXXX----------------[]----[]--------------------------------SSSS---------------------
-----------------------E------------------XXXXXXXXXXXXXXXXXXXXXXXXXXX----------------[]----[]-------E-----------XXX----------SSSS---------------------
------------------SSSS------------------S-XXXXXXXXXXXXXXXXXXXXXXXXXXX----------------[]----[]---QQQQQQ---------------SSS-----SSSS---------------------
------------------------------------------XXXXXXXXXXXXXXXXXXXXXXXXXXX----------------<>----[]---------------------------------------------------------
------------------------------------------XXXXXXXXXXXXXXXXXXXXXXXXXXX----------------------[]------------------------S--------------------------------
---------------------------------------S--XXXXXXXXXXXXXXXXXXXXXXXXXXX----------------------[]-----------------------S-S-------o-----------------------
------------------------------------------XXXXXXXXXXXXXXXXXXXXXXXXXXX----------------------[]---SSSSS-----S-SS---------S?S---S?SS---------XXX---------
X-----------------------------------------XXXXXXXXXXXXXXXXXXXXXXXXXXX----------------------<>---SSSSSSSSSSSSSS---------------SSS----------------------
X----------B----------------------------E-XXXXXXXXXXXXXXXXXXXXXXXXXXX---------------------------SSSSSSSSSSSSSS---------------SS-----------------------
X----------b------------------------------XXXXXXXXXXXXXXXXXXXXXXXXXXX---------X-----------------SSSSSSSSSSSSSS-----------------E-EE---X---------------
X---XXXXXXXXXXXXXXXXXXXXXXXXXXXXXXXXXXXXXXXXXXXXXXXXXXXXXXXXXXXXXXXXXXXXXXXXXXXXXXXXX--XXXXXXE--XXXXXXXXXXXXXX------XXXXXXXXXXX-XXXXXXX---------XXX---
