------------------------------------------------------------------------------------------------------------------------------------------------------
------------------------------------------------------------------------------------------------------------------------------------------------------
------------------------------------------------------------------------------------------------------------------------------------------------------
------------------------------------------------------------------------------------------------------------------------------------------------------
--------------------------------------------------------------------------E---------------------------------------------------------------------------
-------------------SSSSSSSS---------------E------E------------------------S-------------------------------------------------------------SSSS----------
---------------------------------------E--------------------------------------------------X----E----------------------------QQ---------E-----E--------
--------------------------------------------------------------------------?-----------------X---------------------------------------------------------
-oo-----------------E---E-----------XSSSSSSSSSSSS----------------------------------------E--X---------------------------------------E-----------------
ooo----------------SSSSSSSS--------XX-----------------------QQ----X----------------------X--X----------------S----------------------------------------
---------------oo-----------------XXX----oooooo-------------------X-------X-----------E--X--X---------------------------------------------------------
Q--------------oo----------------XXXX-----------------------------X-------X-----------X--X--X--------------SS-SS---------XXXXXXX----------------------
--------------------------------XXXXX----oooooo-------------------X-------X-----------X--X--X----------X---SS-SS-------------------------------------X
XXXXXEEXEXXXXXXXXXXXXXXX--XXXXXXXXXXXXXXXXXXXXXXX-----X--XXXXX--XXXXXXXXXXXX-XXXXXXX--X--X--X-----XXXXXXXXXXXXXXXXXXXXXX------------------------XXXXXX
