------------------------------------------------------------------------------------------------------------------------------------------------------
------------------------------------------------------------------------------------------------------------------------------------------------------
------------------------------------------------------------------------------------------------------------------------------------------------------
--------------------------------------------------------------XX--------------------------------------------------------------------------------------
--------------------------------------------------------------XX--------------------------------------------------------------------------------------
----------------------------------------------------------S---XX-------------------------------------------------------------------------------------E
--------------------------------------------------------------XX-----------------------------------------------------------------------------------XXX
--------------------------------------------------------------XX--------------------------------------------------------------------------------------
--------------------------------------------------------------XX--------------------Q--?--------------------E-----------------------------------------
QQQQ-------------------S?S-----XX-------------------<>---SS---XX-----------------Q-E-----SSS----E-----E----<>-------------------E--S--------------X---
-------B-----E---B------------EXX-----B-----E---E---[]--------XX-------------------E-----------<>----<>------------------------<>---------E------XXX--
E------b---------b-----------XXXX-----b-------------[]--------XX-------------------------------------------------------------------------<>-----XXXX--
----------------------------XXXXX-------------------[]--------XX--------X----------------------------------------------------------------------XXXX---
XXXXXXXXXXXXXXXXXXXXXXXXXXXXXXXXXXXXXXXXXXXXXXXXXXXXXXXXXXXXXXXXXXXXXXXXXXXXXXXXXXXXXXXXXXXXXXXXXXXXXXXXXXXXXXXXXX---XXXXXXXXXXXXXXXXXXXXXXXXXXXXXX---
