------------------------------------------------------------------------------------------------------------------------------------------------------
------------------------------------------------------------------------------------------------------------------------------------------------------
------------------------------------------------------------------------------------------------------------------------------------------------------
------------------------------------------------------------------------------------------------------------------------------------------------------
------------------------------------------------------------------------------------------------------------------------------------------------------
--E-----oo----------------------------------------------------------SS-----------------------------------------------------------------------------S--
----------------XX--------------------------------------------------------------------------------------------------------XSSSS-----------------------
----------------------------XX----------------------------------------------o--------------------------------oo----------XXX--------------------------
----------------------------XX------------------------------------------------------------------------------------------XXXS---------------ooo--------
----XXXX--XXXX------------XXXX------------------QQ-----------------XXXX--SSS-------------------ooo-------XXX------------XXXX-----------------------S--
--------------------------XXXX----------------------------------XXXXX-----------------------------------XXXX----------XXXXXX-SSSS-------<>------------
--------------------------XXXX-------------------------------XXXXXX------------------------------------XXXXX---------XXXXXXX------------[]------------
oooo----------------------XXXX---------X------------------XXXXXXX-------------------------------------XXXXXX------------XXXX------------[]------------
XXXX-------------XXXXXXXXXXXXXXXXXXXXXXXXXXXXXXXXXXX--XXXXXXXXX------XX--XXXXXXXXXXXXXXXXX--XXXXXXXXXXXXXXX---XXXXXXXXXXXXXXXXX---XXXXXXXXXXXXXXXXXXXX
