--------------------------------------------------------------------------------------------------------------------------o---------------------------
------------------------------------------------------------------------------------------------------------------------------------------------------
--------------------------------------------------------------------------------------------------------------XXXXXXXXXXXXX----------------SSSSSSSSSSS
------------------XX------------------------------------------------------------------------------------------XXXXXXXXXXXXX------------------[]---[]--
------------------XX------------------------------------------------------------------------E-----------------XXXXXXXXXXXXX------------------[]---[]--
?-------------S---XX--------------------------------------------------------------------SSS-----------------S-XXXXXXXXXXXXX------------------[]---[]--
------------------XX------------------------------------------------------------------------------------------XXXXXXXXXXXXX------------------<>---[]--
------------------XX------------------------------------------------------------------------------------------XXXXXXXXXXXXX-----------------------[]--
------------------XX-------------------Q--?----------------E----E------------------------------------------S--XXXXXXXXXXXXX-----------------------[]--
-------------SS---XX-----------------Q-------ESSS----E----<>---<>--------------------E--SSS-------------------XXXXXXXXXXXXX-----------------------[]--
----<>------------XX-------------------E------------<>-----------------------------X<>------------------------XXXXXXXXXXXXX-----------------------<>--
----[]------------XX----------------------------------------------------------------------------------------E-XXXXXXXXXXXXX---------------------------
----[]E-----------XX--------X---------------------------------------------------------------------------------XXXXXXXXXXXXX-----------X---------------
XXXXXXXXXXXXXXXXXXXXXXXXXXXXXXXXXXXXXXXXXXXXXXXXXXXXXXXXXXXXXXXXXXXXX---XXXXXXXXXXXXXXXXXXXXXXXXXXXXXXXXXXXXXXXXXXXXXXXXXXXo----XXXXX-XXXXXXX--XXXXXE-
