------------------------------------------------------------------------------------------------------------------------------------------------------
------------------------------------------------------------------------------------------------------------------------------------------------------
-----------------------------------------E-----------------------------------------------------XXXXXXX------------------------------------------------
------------------------------------------------------------------------------------------------------------------------------------------------------
---------------------------------------------------------------XX-------------------------------------------------------------------------------------
-------------------------------XX------------------------------------------------------XXX------------------------------------------------------------
------------------------------XXX----------------------------E----------o-----------------------------------------------------------------------------
-----------------------------XXXX------------------------XXXXXX-------------------------------------------------------------------------------------X-
----------------------------XXXXX---------------------------------XXX---------------------------------------X-EE----X--------------ooo-------------XX-
-----------S---S-----------XXXXXX---S-------------------------------------ooooooo--XXX----------------------XSSSSS-SX--------------ooo------------XXX-
--------------------------XXXXXXX---------------------XXXX----------------o----------------------------------------------------------------------XXXX-
-XXXE--------------------XXXXXXXX---------------------------------------------------------------------------------------------------------------XXXXX-
XXXX--------------------XXXXXXXXX--------XX----------------------------XXXXXXXXXX------------E--------------------------------------------------------
XXX--------------XXXXXXXXXXXXXXXXXXXXXXXXXXXXXXXXXXX-------------XXX------------X----------XXXXXXXXXXXX---XXXXXXX--XXXXXEEXEXXXXXXXXXXXXEEXEXXXXXXXXXX
