------------------------------------------------------------------------------------------------------------------------------------------------------
------------------------------------------------------------------------------------------------------------------------------------------------------
------------------------------------------------------------------------------------------------------------------------------------------------------
------------------------------------------------------------------------------------------------------------------------------------------------------
------------------------------------------------------------------------------------------------------------------------------------------------------
-----------------XXXXX------------------------------------------------------XXX-----XXXXXXE-----------------------------XXXXXX-----XXXXXXE------------
S---------------------------------------------------------------------XXX-----------------------------------E-----------------------------------------
X-----------------------------------------------------------------------------------------------------------------------------------------------------
X--X--------------------------------------------------------------------------------------------------------------------------------------------------
X-------------------------------X-------------------------------XXXX--------XXX-----------------------------------XXX---------------------------------
X-------------------------------X-----------------------------------------------------------------------------XX--------------------------------------
X---------B------------------SSSX----------------X----------------------------------------------------------------------------------------------------
X---------b--------X-----------------------------X-----------------------------------------XXXXEXXEX----XXX-------------------------------XXXXEXXEX---
X----XXXXXXXXXXXXXXXXXXXXXXXXXXXXXXXXXXX--XXXXXXXX--XXXXXXXX------------------------------------------------------------------------------------------
