------------------------------------------------------------------------------------------------------------------------------------------------------
------------------------------------------------------------------------------------------------------------------------------------------------------
SSSSSSSSSSSSSSSSSSSSSSSSSSSSSSS----------SSSSSSSSSSSSSSSSSSSSSSSSSSSSSSSSSSSSSSSSSSSSSSSSSSSSSSSSSSSSSSSSSSSSSS-------SSSS-----SSSSSS----SSSSSSSSSSSSS
SSSSSSSSSSSSSSSSSSSSSS-------------------------------------------------------------------------------------------------------------------SSSSSSSSSS---
SSSSSSSSSSSSSSSSSSSSSS-----------XXX-----------------------------------------------------------------------------------?-----------------SSSSSSSSSS---
SSSSSSSSSSSSSSSSSSSSSS--QQ------------SSS------------E------------------------E---------------------------------------S??----------------SSSSSSSSSS---
----------------------------------------------------<>-----------------------<>--------------------------------------------XXX--------------S---------
--------------------------------------S-------------[]-----------------------[]-------------------------------------------------------------S---------
-?-----------------------------------S-S------------[]-------S---------------[]-------S--------------------E--------------------------------S---------
???SSSSSSSSSSSSSSSSSSS--QQ--QQQ---------S------E--SS[]SS---E----E-------E--SS[]SS---E----E----------------<>------XXX-SSSS---------------------<><>---
---SSSSSSSSSSSSSSSSSSS------------------------<>----[]----<>---<>------<>----[]----<>---<>-------------XX-[]--XXX------------------E--------XX-[][]---
---SSSSSSSSSSSSSSSSSSS------------------------[]----[]----[]---[]------[]----[]----[]---[]------------XXX-[]--XXX-----------------<>-------XXX-[][]---
oooSSSSSSSSSSSSSSSSSSS------------------------[]-E--[]----[]---[]------[]-E--[]----[]---[]--------E-E-XXX-[]--XXX-----------------[]----E--XXX-[][]---
XXXXXXXXXXXXXXXXXXXXXXXXXXXXXXX------XXXXXXXXXXXXXXXXXXXXXXXXXXXXXXXXXXXXXXXXXXXXXXXXXXXXXXXXXXXXXXXXXXX--XX--XX------XXXX------XXXXXXXXXXXXXX-XXXXXXE
