------------------------------------------------------------------------------------------------------------------------------------------------------
------------------------------------------------------------------------------------------------------------------------------------------------------
------------------------------------------------------------------------------------------------------------------------------------------------------
------------------------------------------------------------------------------------------------------------------------------------------------------
------------------------------------------------------------------------------------------------------------------------------------------------------
-------SSSSSSSS------------------------------------------------------------------------XX-----------------------------------------------SSSSSSS-------
--------------------------------------------------------------------------------------XXX-------------------------------------------------------------
----------------------------o--------------------------------------------------------XXXX-------------------------------------------------------------
--------E---E-----------XSS-------ooo-----------------------------------------------XXXXX---------------------<>-------------------------E--E---------
------SSSSSSSSS--------XXX-----------------E---------------------------------------XXXXXX--S--------------QQ?-[]------------------------SSSSSSS-------
----------------------XXXX-----<>--------------E-QQ?------------------------------XXXXXXX---------------------[]------------------Q?Q----------------X
-<>------------------XXXXX-----[]------------------------------------------------XXXXXXXX---------------------[]------------------------------------XX
-[]-----------------XXXXXX-----[]------------------------X-----X-----X----------XXXXXXXXX----------------X----[]-----------------------------------XXX
XXXXXXXXXXXX--XXXXXXXXXXX-XXXXXXXXXXXXXXXXXXXXXXXXXXXXXXXX-----X-----XXXXXXXXXXXXXXXXXXXXXXXXXXXXXXXXXXXXXXXXXXXXXXXXXXXXXXXXXXXXXXXXXXXXXXX--XXXXXXXX
