------------------------------------------------------------------------------------------------------------------------------------------------------
------------------------------------------------------------------------------------------------------------------------------------------------------
------------------------------------------------------------------------------------------------------------------------------------------------------
------------------------------------------------------------------------------------------------------------------------------------------------------
------------------------------------------SSS---SSSS-----------ooooooo-ooooooooooooooo--E------------------E------------------------------------------
---------X---------S---------XQQ?QQX-------------------------SSSSSSSSSSSSSSSSSSSSSSSSSSSSS---SSSS-SSSSSSSSSSSSS-------------------------------------QQ
-------------------S---------X-----X------------------------------------------------------------------------------------------------------------------
-----E-----------------------X-----X------X-----------------------------------------------------------------------------------------------------------
?---<>-------------SSS-------XE-E--X------XEE------X-------------------------------------------------------E-----X------------------------------------
----[]-------------SSS-------XQQ-QQX------XSSSSSSSSX---------------------?----XXXXXSSSSSS--X?--------------QQ?QQQX---------------------------<>----E?Q
----[]-------------SSS--------------------------------------------------------------------XX-------------------------------------------------[]-------
Q---[]--------------SS-------------E-----------------------------------------------------XXX-------------------------------------------------[]-------
-----]------------X-SS-------------------------------------------XXXXX--------------E---XXXX-----------X-----------------E-------------------[]-------
XX---XXXXXX-------XXXXXXXXXXXXXXXXXXXXXXXXXXXXXXXXXX----XXX------------------------XXXXXXXXXXXXX-------XXXXXXXXXXXXXXXXX--XXXXXXXXXXXXXXXXXXXXXXXXXXXX
