------------------------------------------------------------------------------------------------------------------------------------------------------
------------------------------------------------------------------------------------------------------------------------------------------------------
-------------------------------------------------------------------------------------------------------------------------XXXXXXXXX--------------------
------------------------------------------------------------------------------------------------------------------------XXXXXXXXXX--------------------
------------------------------------------------------------------------------------------------------------------------XXXXXXXXXX--------------------
---------------------XX----------------------------------------------------SS--------------------SSSS-----------------S-XXXXXXXXXX--------------------
<>-------------------[]------------------------------------<>-------------------------------------[]--------------------XXXXXXXXXX--------------------
[]-------------------[]------------------------------------[]-------------------------------------[]--------------------XXXXXXXXXX--------------------
[]-------------------[]-----------------------------E------[]-------------------------------------[]--------------------XXXXXXXXXX--------------------
[]-------------------<>SSSSSS-----------------------------S[]-------------------------------------[]-----------------SS-XXXXXXXXXX--------------------
[]------------X---------------------------------oo---------[]--------------B------------B---------<>--------------------XXXXXXXXXX--------------------
[]------------XX------E-------------------------oo---------[]--------------b------------b----------------------<>-------XXXXXXXXXX--------------------
[]------B-----XXXX------E----------------------------------[]--------------BE-----------B----------E-----------[]-------XXXXXXXXXX-----------X--------
XXXXXXXXX-----XXXXXXXXX<>XXXXXXXXXXXXXXXXXXXXXXXXXXXXXXXXXXXXXXXXXX-XXXXXXXXXXXXXXXXXXXXXXXXXXXXXXXXXXXXEXXXXXXXXXXXXXXXXXXXXXXXXX--XXXXXXXXXXXXXXXXXX
