------------------------------------------------------------------------------------------------------------------------------------------------------
------------------------------------------------------------------------------------------------------------------------------------------------------
---------------------------------------------------------------------]----------------------------------------------------------------------XXXXXXXXXX
---------------------------------------------------------------------]----------------------------------------------------------------------XXXXXXXXXX
------------------------------------------------------------------------------------------------------------------------E-------------------XXXXXXXXXX
--------------------------------------------------------------------XX------E-------------------------XX---------E--SSS-------------------S-XXXXXXXXXX
------------------------------------E------------------------------XXX-------------------------------XXX------E-----------------------------XXXXXXXXXX
-----------------------------------<>-----------------------------XXXX------------------------------XXXX------------------------------------XXXXXXXXXX
-----------------------------------[]----------------------------XXXXX--SSSS-----------------------XXXXX---------------------------------S--XXXXXXXXXX
-------<------------------XSSS-----XX---------------------------XXXXXX----------------------------XXXXXX-----------SSSS---------------------XXXXXXXXXX
-------[]-----------------X----------------------------E----E--XXXXXXX----------------------------XXXXXX------------------------------------XXXXXXXXXX
-------[]-----------------X-----------B---<>-----B-----]------XXXXXXXX---------------X------------XXXXXX----------------------------------E-XXXXXXXXXX
E------[]----------------EX---------------[]-----------------XXXXXXXXX-------------------XXXX-----XXXXXX------------------------------------XXXXXXXXXX
XXXXXXXXXXXXXXXXXX--XXXXXXXXXXX---XXXXXXXXXXXXXXXXXXXXXXXXXXXXXXXXXXXXXXXXXXXXXXXXXXXXX-----------XXXXXX----------XXXXXXXXXXXXXXXXXXXXXXXXXXXXXXXXXXXX
