------------------------------------------------------------------------------------------------------------------------------------------------------
------------------------------------------------------------------------------------------------------------------------------------------------------
------------------------------------------------------------------------------------------------------------------------------------------------------
------------------------------------------------------------------------------------------------------------------------------------------------------
-------------------------------------------------------------------------------------------------------------------------E----------------------------
XXXXX---------------------------------------------------------------------------------------------------SSSSS---------XXXQQ?QQS-----------------------
-------------------------------------------------------------------------------------------------------S----------------------------------------------
------------------------------------------------------------------------------------------------------SS----------------------------------------------
---------------------------------------------------------------------------------B-------------------SSS--------------------------X-------------------
-------------------------------------------------------------------------B-------b------------------SSSS----------------------SSSSX-------------------
-----------------------B---------------------E---------------------------b--?-B------?QQ-----------------------------------------------------------B--
-----------------------b-------------------------------------------------B----b----------------------------------------------E---------------------b--
-----------E-----------BEE-------------------------------E-EE-------------------------------E-------B----------------------------------------------BEE
XXX--XXXXXXXXXXXXXXXXXXXXXXXXXXXXXXXXXXXXXXXXXXXXXXXXXXXXXXXXXXXXXXXXX>XXXXXXXXXXXXXXXXXXXX<>XXXXXXXXXXXXXXXXXXX---XXXXXXXXXXXXXXXXXXXXEXXXXXXXXXXXXXX
