------------------------------------------------------------------------------------------------------------------------------------------------------
------------------------------------------------------------------------------------------------------------------------------------------------------
------------------------------------------------------------------------------------------------------------------------------------------------------
------------------------------------------------------------------------------------------------------------------------------------------------------
------------------------------------------------------------------------------------------------------------------------E-----------------------------
---------------E--S---SSSSSSSSS------------SS---SS-------------SS----------------XX-----------------------------------------------------SSSSSSSSSSSS--
--------------<>----------------------------------------------------------------------E--------------------------S--------<>--------------------------
--------------[]---------------------------------------------------------------------<>-----------------------------------[]--------------------------
--------------[]-------------------------SS--------------------SS-------------S------[]-----------------------------------[]--------B-----------<>----
-----<>------SXXS------------------------------SSS---------XX-------------<>---------[]-----------------------------X-----XX-------XXXXESSSSSS?-[]----
>----[]-----------------------------------------------XX<>-XX-------------[]---------[]------<>----E--------E---------------------XXXXXX--------[]----
[----[]-<>--------<>--------------<>--<>-------------XXX[]-XXX-SS---------[]---------[]------[]------------<>--------------------XXXXXXX--------[]----
-----[]-[]--------[]--------------[]--[]------------XXXX[]-XXX-SS---------[]---------[]------[]------------[]-----X-------------XXXXXXXX--------[]----
XXXXXXXXXXXXXXXXXXXXXXXXXX------XXXXXXXXXXXX-X-XXXXXXXX-XXXXXXXXXXXXXXXXXXXXXXXXXXXXXXXXXXXXXXXXXXXXXXXXXXXXXXXXXXX-------------XXXXXXXXXXXXXXXXXXXXXX
