-----------------------------------------------------------------------------------------------------------------------------------------------S------
-----------------------------------------------------------------------------------------------------------------------------------------------S------
SSSSSSSSSSS-------------SSS--[]SSSSSSSSSSSSSSSSSS-------------SSSSSSSSSSSSSSSSSSSSSSSSSSSSSSSSSSSSSS-SS--------SSS---SSS-------------SSS--[]SSSSSSSSSS
-----------------------------[]SSSSSSSSSSSSSSSSSS---------------[]----[]------------------------------------------------------------------[]SSSSSSSSSS
-----------------------------[]SSSSSSSSSSSSSSSSSS---------------[]----[]-------E----------------------------------------------------------[]SSSSSSSSSS
-----------------------------[]SSSSSSSSSSSSSSSSSS---------------[]----[]---QQQQQQ---------------------<>----------------------------------[]SSSSSSSSSS
-----------------------------[]SSSSSSSSSSSSSSSSSS---------------<>----[]------------------SSSSSSSSSSSS[]----------------------------------[]SSSSSSSSSS
--------------XXX------------[]SSSSSSSSSSSSSSSSSS---------------------[]------------------SSSSSS------[]-------------------XXX------------[]SSSSSSSSSS
------------------------------]SSSSSSSSSSSSSSSSXS---------------------[]------------------SSSSSS------[]-----------------------------------]SSSSSSSSSS
--------XXX-------------------]SSSSSSSSSSSSSSSSSS---------------------[]---SSSSSSSSSSSSS--SSS-----X--S[]-------------XXX-------------------]SSSSSSSSSS
E----------------SSS-S--SSSSSSSSSSSSSSSSSSSSSSSSS---------------------<>---SSSSSSSSSSSSS----------X---[]-------SSS------------SSS-S--SSSSSSSSSSSSSSSSS
>----------------SSS-S--SSSSSSSSSSSSSSSSSSSSSSSSS--------------------------SSSSSSSSSSSSS----------XX--[]-------SSS------------SSS-S--SSSSSSSSSSSSSSSSS
----X------------SSS-S--SSSSSSSSSSSSSSSSSSSSSSSSS--------X-----------------SSSSSSSSSSSSS--------E-XX--[]----------------------SSS-S--SSSSSSSSSSSSSSSSS
XXXXX---------XXXSSS-S--XXXXXXXXXXXXXXXXXXXXXXXXXXXXXXXXXXXXXXXX--XXXXXXE--XXXXXXXXXXXXXXXXXXXXX?XXXXXXXXXXXXXXXXX---------XXXSSS-S--XXXXXXXXXXXSXXXXX
