------------------------------------------------------------------------------------------------------------------------------------------------------
------------------------------------------------------------------------------------------------------------------------------------------------------
-----------------------------------------------------E-----SSSSSSSSSSSSSSSSSSSSSSSSSSSSSSSSSS---------------------------------------------------------
---------------------------------------------------------------------------------------------------E--------------------------------------------------
----E--------------------------------------------------------------------------------------------XXXXX-------------XXX--------------------------------
---SQS--SQS--------------------------------XXX----------------------------------------------------------------------------------------XX--------XXX---
------------------------------------------XXXX---------------------------------------------------------------o-----------------------XXX--------XXX---
---------------------o------XX-----------EXXXX---------------------------------B-----------XX---------------------------------------XXXX--------XXX---
----------------------E-----XX----------XXXXXX---------------------------------b-----------------------XXX-------------------------XXXXX--------XXX---
---SQS--S?S--------SSSSS----XX---------XXXXXXX--------------------------------XXX<SSSSS---XX--------------------------------------XXXXXXS-------XXX---
----------------E--E-------XXX-------EXXXXXXXX--------------------XXX--------XXXX]------------------------------------SS---------XXXXXXX--------XXX---
-----------------------E---XXX-------XXXXXXXXX------------------------------XXXXX]------------------------------------SS--------XXXXXXXX--------XXX---
E--------------------------XXX------XXXXXXXXXX-------XX-------------------XXXXXXXX--------------------------XX--------SS-------XXXXXXXXX--------XXX---
XXXXXXXXXXXXXXXXXXXXXXXXXXXXXX---XXXXXXXXXXXXXXXXXXXXXXXXXXXXXXX---------XXXXXXXXXXXXXX-------XXXXXX--XXX------------XSSXXXXXXXXXXXXXXXXXX------XXX---
