------------------------------------------------------------------------------------------------------------------------------------------------------
------------------------------------------------------------------------------------------------------------------------------------------------------
------------------------------------------------------------------------------------------------------------------------------------------------------
------------------------------------------------------------------------------------------------------------------------------------------------------
------------------------------------------------------------------------------------------------------------------------------------------------------
------------------------------------------------------------------------------------------------------------------------------------------------------
E-----------------------E------------------------------------------------------------------------E----------------------------------------------------
>----------------------<>-----------------------------------------------------------------------------------------------------------------------------
-----------------------[]---------------------------------------------------------E----------------------------------------E--------------------------
--------------XSSS-----XX---------------------------------E----------------------<>-------------------------------oooooooo<>-------?QQQQQQ?-----------
S-------------X---------------------------?QQ------------------------------------[-----------------XXXXXXXXX------oooooooo[]--------------------------
S-S-----------X-----------B---<>-----B-------------------------------E------------------------XXX-------------------------[]---<>--------------------?
o-S--------E-EX---------------[]-----------------------------------------------------------XXXXXX--------------XXXXXXXXX--[]---[]--B-E----B------E----
XXXXXXXXXXXXXXXXXXX---XXXXXXXXXXXXXXXXXXXXXXXXXXX--XXXXXXXXX--XXXXXXXXX--XXXXXXXXXX--XXXXXXXXXXX---------------XX----------]---[]--bXXXX-XXXXXXXXXXXX-
