------------------------------------------------------------------------------------------------------------------------------------------------------
------------------------------------------------------------------------------------------------------------------------------------------------------
SSSSSSSSSSSSSSSSSSSSSSSSSSSSSSSSSS-----SSSSSS--SSSSSSSSSSSSSSSSSSSSSS----SSSSSSSSSSSSSSSSSSSSSSSSSSSSSSSSSSSSSSSSS?SSSSSSSSSSSSSSSSSSSSSSSSSSSSSSS----
-----------SSSSSSSSSSSSSS-------[]---------------------------------------------SSSS---S-S--SSSS------SSSS---------------------------------------------
-----------SSSSSSSSSSSSSS-------[]---------------------------------------------SSSS---S-S--SSSS--E---SSSS---------------------------------------------
-----------SSSSSSSSSSSSSS-------[]----------------------oooo------SS------S-S---S-----S-S---S----SS----------oooooo-----------------------------------
--------------------------------[]-------SSSSSSSS-----------------SS------S-S---S-----S-S---S----SS---------------------------------------------------
--------------------------------[]-------SSSSS--------S-SSSS-S----SS------S-S---S-----S-S---S----SS----------SSSSSS----------------------------------X
--------------------------------[]-------SSSSS--------SoS--SoS----SS----?-SoS---So??--S-S---So??-SS---E------SSSSSS-----------------------------------
SSS????????SSSSSSSSSE??<>-------[]------?SSSSS???-----SSS--SSS----SS------SSS---SSS---S-S---SSS--SS--SSSS-----------------------<>-------------XXX----
SSSSSSSSSSS------------[]-------<>-------SSSSSSSS-------------------SS------------------------------EE--------------------------[]--------------------
SSSSSSSSSSS------------[]----------------SSSSSSSS-------------------SS----------------------------------------------------------[]----<>--------------
>----------------------[]------------------------E------------------------------------------------------------------------------[]--E-[]--------------
XX-XXXXXXXXXXXXXXXXXXXXXXXXEXXXXXXX----XXXXXX-XXXXXXXXXXXXXXXXXXXXXXXXXXXXXXXXXXXXXEXEXXXXXXXXXXXXXXXXXXX---XXXXXXXEXXXXXXXXXXXXXXXXXXXXXXX----------X
