------------------------------------------------------------------------------------------------------------------------------------------------------
------------------------------------------------------------------------------------------------------------------------------------------------------
SSSSSSSSSSSSSSSSSSSSSSSSSSSSSSSSSSSSSSSSSSSSSSSSSSSSSSSSSSSSSSSSS-------------------------------------------------------------------------------------
------------S--SSSSSS--SSSS---------------------------------------------------------------------------------------------------------------------------
------------S--SSSSSS--SSSS----------------------------------------XXX--------------------------------------------------------------------------------
----------SS-------SS---S---------------------------------------------------------XXX------------------------------------------------------------QQQ--
----------SS-------SS---S-----------------------------------------------------------------------------------------------------------------------------
----------SS-------SS---S-----------------------------------------------------------------------------------------------------------------------------
--ooo-----SS---ooooSS---So???-------------------------------------------SSSSS??----------------------------------X------------------------------------
----------SSS--SSSSSS---SSS------------------------------------XXX-----------------------------------ooo--------EX---------------SSS-------------QQQQQ
>-----------S------------------------------------SS-----------EXXX-XXX-----------------------------------------XXX------<>----E-----------------------
]-----------S------------------------------------SS----------XXXXX--------------------------------------------XXXX------[]------------------------E---
]------------------------------------------------SS---------XXXXXX----------------------------X--------------XXXXX------[]----------------------------
XXXXXXXXXXXXXXXXXXXXXXXXXXXXXX--XXXXXXX--XXX--X--XX--XXXXXXXXXXXX-------XXXXXXXX--XXXXXXXXXXXXXXXXXXXXXXXXXXXXXXXXXXXXXXXXXXXXXXXXXXXXXXXXXXXXXXXXXXXX
