------------------------------------------------------------------------------------------------------------------------------------------------------
------------------------------------------------------------------------------------------------------------------------------------------------------
------------------------------------------------------------------------------------------------------------------------------------------------------
------------------------------------------------------------------------------------------------------------------------------------------------------
--------------------------------------------------------------------------XXX-------------------------------------------------------------------------
XXX-------------------------------------------------------------------------------E-------------------------SSSSS-----------------------XX------------
-------------------------------------------------------------------------------------------------------------------X--X-----------E-----XX------------
-------------------------------------------------------------------------------------------------------------------X--X----------<>-----XX------------
-----------------------------------------------------X------------------------SSSS-SS----------------------------X-XE-X----------[]-----XX------------
--------------------------------------------S?S-----EX---S---------------------------------------------------EXXXX-XQQX----------XX-----XX------------
---------------------B-----------------------------XXX-------------------------------------------------X--------------------------------XX------------
---------------------b----------------------------XXXX---------------XXXEXXXX----------------------E---X----------------------------B-----------------
---------E-----------BEE-------------X-----------XXXXX----EE---B-----XX--------------------------------X---------------------------------------------E
X--XXXXXXXXXXXXXXXXXXXXXXXXXXXXXXXXXXXXXXXXXXXXXXXXXXXXXXXXXXXXX-----XX-------XXXXXXXX---XXXXXXXXXXXX--XXXXXXXXXXXXXXXXXXXXXXX--XXXXXXX-XXXXXX--XXXXXX
